Match,Date,Bet,Return,Gain,Meta,Odds,Bet Type,Balance,Comments
"Real Madrid @ 2.30
$20.00 Single",05/26/2018 11:14:25,20,46,26,UCL,2.3,regular,226,
"GS Warriors -6.5 @ 1.90
$10.00 Single",05/28/2018 8:37:48,10,19.1,9.1,NBA,1.9,regular,235.1,
"Spain @ 1.95
$50.00 Single",05/29/2018 14:17:23,50,50,0,WC,1.95,regular,235.1,
"GS Warriors -11.5 @ 1.90
$20.00 Single",06/02/2018 13:34:35,20,38.19,18.19,NBA,1.9,regular,253.29,
"England @ 1.44
$20.00 Single",06/12/2018 10:27:39,20,20,0,WC,1.44,regular,253.29,
"Spain @ 2.10
$33.29 Single",06/13/2018 7:16:40,33.29,0,-33.29,WC,2.1,regular,220,
"France @ 1.25
$50.00 Single",06/13/2018 13:46:09,50,62.5,12.5,WC,1.25,regular,232.5,
"Draw @ 4.50
$5.00 Single",06/13/2018 20:45:55,5,4.5,-0.5,WC,4.5,regular,232,
"Draw @ 4.33
$5.00 Single",06/14/2018 8:26:03,5,0,-5,WC,4.33,regular,227,
"Egypt @ 9.00
$5.00 Single",06/15/2018 5:45:39,5,5,0,WC,9,regular,227,
"Draw @ 4.00
$5.00 Single",06/15/2018 6:09:05,5,0,-5,WC,4,regular,222,
"Spain @ 4.33
$10.00 Single",06/15/2018 13:22:37,10,0,-10,WC,4.33,regular,212,
"Spain @ 4.75
$5.00 Single",06/15/2018 13:58:24,5,0,-5,WC,4.75,regular,207,
"Draw @ 5.00
$5.00 Single",06/16/2018 6:57:54,5,25,20,WC,5,regular,227,
"Egypt @ 2.37
$27.00 Single",06/16/2018 10:38:17,27,0,-27,WC,2.37,regular,200,
"Peru @ 19.00
$5.00 Single",06/16/2018 12:20:17,5,0,-5,WC,19,regular,195,
"Peru @ 19.00
$5.00 Single",06/16/2018 12:22:49,5,0,-5,WC,19,regular,190,
"Germany -1.0,-1.5 @ 2.070
$50.00 Single",06/17/2018 5:13:59,50,50,0,WC,2.07,regular,190,
"Germany -1.0,-1.5 @ 2.070
$30.00 Single",06/17/2018 5:15:01,30,0,-30,WC,2.07,regular,160,
"Sweden 0.0,-0.5 @ 1.930
$20.00 Single",06/18/2018 6:35:41,20,38.6,18.6,WC,1.93,regular,178.6,
"Over 2.5 @ 1.70
$20.00 Single",06/18/2018 9:25:53,20,34,14,WC,1.7,goals,192.6,
"Morocco +0.5,+1.0 @ 2.080
$20.00 Single",06/18/2018 17:47:26,20,20,0,WC,2.08,regular,192.6,
"Egypt +0.5 @ 1.830
$12.60 Single",06/18/2018 18:34:05,12.6,12.6,0,WC,1.83,regular,192.6,
"Colombia @ 1.75
$22.60 Single",06/18/2018 20:38:44,22.6,0,-22.6,WC,1.75,regular,170,
"Over 2.0,2.5 @ 1.930
$20.00 Single",06/20/2018 6:44:56,20,0,-20,WC,1.93,goals,150,
"Saudi Arabia +1.5,+2.0 @ 1.960
$20.00 Single",06/20/2018 9:55:16,20,39.2,19.2,WC,1.96,regular,169.2,
"Australia +0.5 @ 1.980
$20.00 Single",06/21/2018 6:37:29,20,20,0,WC,1.98,regular,169.2,
"Australia +0.5 @ 2.010
$20.00 Single",06/21/2018 6:49:41,20,40.2,20.2,WC,2.01,regular,189.4,
"Over 2.0,2.5 @ 2.125
$20.00 Single",06/21/2018 7:56:04,20,0,-20,WC,2.125,goals,169.4,
"Over 2.0 @ 1.810
$19.40 Single",06/21/2018 9:48:09,19.4,0,-19.4,WC,1.81,goals,150,
"Serbia @ 3.75
$10.00 Single",06/22/2018 14:29:56,10,0,-10,WC,3.75,regular,140,
"South Korea +0.5,+1.0 @ 1.920
$20.00 Single",06/23/2018 6:46:37,20,19,-1,WC,1.92,regular,139,
"No @ 2.05
$20.00 Single",06/23/2018 9:08:41,20,0,-20,WC,2.05,both score,119,
"No @ 2.05
$19.00 Single",06/23/2018 9:45:02,19,0,-19,WC,2.05,both score,100,
"No @ 1.70
$20.00 Single",06/24/2018 9:51:07,20,0,-20,WC,1.7,both score,80,
"Colombia 0.0,-0.5 @ 1.890
$30.00 Single",06/24/2018 11:54:08,30,56.7,26.7,WC,1.89,regular,106.7,
"Yes @ 1.95
$20.00 Single",06/24/2018 17:20:21,20,39,19,WC,1.95,both score,125.7,
"Under 9.5 @ 1.900
$15.70 Single",06/25/2018 12:43:24,15.7,29.83,14.13,WC,1.9,goals,139.83,
"Australia 0.0 @ 1.850
$19.83 Single",06/25/2018 16:25:22,19.83,36.69,16.86,WC,1.85,regular,156.69,
"Nigeria @ 6.25
$5.00 Single",06/26/2018 8:15:16,5,0,-5,WC,6.25,regular,151.69,
"Nigeria @ 29.00
$1.69 Single",06/26/2018 13:51:31,1.69,0,-1.69,WC,29,regular,150,
"No @ 1.90
$20.00 Single",06/26/2018 20:01:11,20,20,0,WC,1.9,both score,150,
"France 0.0,-0.5 @ 2.040
$30.00 Single",06/26/2018 20:48:13,30,61.2,31.2,WC,2.04,regular,181.2,
"France @ 2.40
$20.00 Single",06/26/2018 21:06:07,20,48,28,WC,2.4,regular,209.2,
"France 0.0,-0.5 @ 1.990
$20.00 Single",06/27/2018 5:49:29,20,39.8,19.8,WC,1.99,regular,229,
"Sweden -0.5 @ 1.975
$20.00 Single",06/27/2018 8:00:28,20,0,-20,WC,1.975,regular,209,
"Serbia 1-0 @ 21.00
$5.00 Single",06/27/2018 12:57:35,5,0,-5,WC,21,regular,204,
"Serbia @ 29.00
$5.00 Single",06/27/2018 14:15:34,5,0,-5,WC,29,regular,199,
"France 0.0,-0.5 @ 2.040
$30.00 Single",06/30/2018 8:20:07,30,61.2,31.2,WC,2.04,regular,230.2,
"France @ 2.37
$20.00 Single",06/30/2018 8:25:29,20,47.5,27.5,WC,2.37,regular,257.7,
"Uruguay 0.0 @ 2.010
$30.00 Single",06/30/2018 11:33:38,30,60.3,30.3,WC,2.01,regular,288,
"Under 9.0 @ 2.10
$20.00 Single",06/30/2018 11:53:01,20,0,-20,WC,2.1,goals,268,
"Russia -1.0 @ 1.850
$18.00 Single",07/01/2018 5:12:18,18,18,0,WC,1.85,regular,268,
"Spain @ 1.80
$18.00 Single",07/01/2018 11:34:44,18,0,-18,WC,1.8,regular,250,
"Denmark +0.5 @ 1.960
$30.00 Single",07/01/2018 12:15:40,30,58.8,28.8,WC,1.96,regular,278.8,
"Denmark +0.5 @ 1.940
$20.00 Single",07/01/2018 12:48:17,20,38.8,18.8,WC,1.94,regular,297.6,
"Brazil -1.0 @ 1.810
$30.00 Single",07/02/2018 8:10:05,30,30,0,WC,1.81,regular,297.6,
"Mexico -1.0 @ 2.000
$20.00 Single",07/02/2018 8:10:24,20,40,20,WC,2,regular,317.6,
"Brazil -1.0 @ 1.800
$30.00 Single",07/02/2018 8:21:06,30,54,24,WC,1.8,regular,341.6,
"Brazil -0.5 @ 2.110
$41.60 Single",07/02/2018 15:57:15,41.6,41.6,0,WC,2.11,regular,341.6,
"France -0.5 @ 2.000
$50.00 Single",07/02/2018 16:12:02,50,100,50,WC,2,regular,391.6,
"No @ 1.66
$41.60 Single",07/02/2018 19:26:31,41.6,69.34,27.74,WC,1.66,both score,419.34,
"England -1.5 @ 1.900
$20.00 Single",07/03/2018 6:53:21,20,38,18,WC,1.9,regular,437.34,
"Antoine Griezmann @ 21.00
$4.34 Single",07/03/2018 12:26:42,4.34,0,-4.34,WC,21,regular,433,
"France -0.5 @ 1.775
$45.00 Single",07/03/2018 13:55:27,45,0,-45,WC,1.775,regular,388,
"France -1.0 @ 1.925
$38.00 Single",07/04/2018 6:06:00,38,38,0,WC,1.925,regular,388,
"England -0.5 @ 1.960
$50.00 Single",07/04/2018 6:28:48,50,98,48,WC,1.96,regular,436,
"No @ 1.61
$18.00 Single",07/05/2018 8:06:16,18,29.08,11.08,WC,1.61,both score,447.08,
"Brazil 0.0,-0.5 @ 1.840
$30.00 Single",07/05/2018 19:47:53,30,0,-30,WC,1.84,regular,417.08,
"Draw 2-2 @ 23.00
$5.00 Single",07/06/2018 6:52:16,5,5,0,WC,23,regular,417.08,
"Draw 2-2 @ 17.00
$5.00 Single",07/06/2018 6:52:51,5,0,-5,WC,17,regular,412.08,
"Brazil -0.5 @ 2.110
$24.08 Single",07/06/2018 11:11:49,24.08,0,-24.08,WC,2.11,regular,388,
"Brazil -0.5 @ 2.125
$50.00 Single",07/06/2018 11:58:05,50,0,-50,WC,2.125,regular,338,
"England -0.5 @ 1.900
$100.00 Single",07/07/2018 6:54:49,100,190,90,WC,1.9,regular,428,
"France 0.0,-0.5 @ 2.125
$100.00 Single",07/07/2018 6:57:38,100,100,0,WC,2.125,regular,428,
"No @ 1.66
$50.00 Single",07/07/2018 8:58:55,50,62.5,12.5,WC,1.66,both score,440.5,
"Under 7.5 @ 1.57
$20.00 Single",07/07/2018 15:39:17,20,31.43,11.43,WC,1.57,goals,451.93,
"France 0.0,-0.5 @ 2.125
$21.93 Single",07/07/2018 20:18:35,21.93,36.57,14.64,WC,2.125,regular,466.57,
"England 0.0,-0.5 @ 2.040
$30.00 Single",07/07/2018 20:19:05,30,15,-15,WC,2.04,regular,451.57,
"England 0.0,-0.5 @ 1.990
$20.00 Single",07/08/2018 20:38:57,20,20,0,WC,1.99,regular,451.57,
"France 0.0,-0.5 @ 2.110
$30.00 Single",07/08/2018 20:40:20,30,63.3,33.3,WC,2.11,regular,484.87,
"Belgium +0.5 @ 1.750
$30.00 Single",07/09/2018 9:57:44,30,30,0,WC,1.75,regular,484.87,
"No @ 2.00
$30.00 Single",07/10/2018 9:44:06,30,60,30,WC,2,both score,514.87,
"Raheem Sterling @ 4.00
$9.87 Single",07/10/2018 20:52:07,9.87,0,-9.87,WC,4,regular,505,
"France -0.5 @ 1.950
$65.00 Single",07/11/2018 22:46:23,65,126.75,61.75,WC,1.95,regular,566.75,
"Under 3.5 @ 1.700
$50.00 Single",07/13/2018 8:59:41,50,85,35,WC,1.7,goals,601.75,
"France -0.5 @ 2.160
$35.00 Single",07/15/2018 9:38:52,35,75.6,40.6,WC,2.16,regular,642.35,
"Draw @ 3.00
$50.00 Single (50.00 Free In-Play Bet)
Free In-Play Bet Redeemed",07/15/2018 10:01:42,50,0,-50,WC,3,regular,592.35,
"Beijing Guoan @ 1.57
$52.35 Single",07/21/2018 11:39:49,52.35,52.35,0,CSL,1.57,regular,592.35,
"Beijing Guoan @ 1.57
$22.35 Single",07/21/2018 11:40:15,22.35,35.13,12.78,CSL,1.57,regular,605.13,
"Beijing Guoan @ 1.57
$3.00 Single",07/22/2018 6:19:27,3,4.72,1.72,CSL,1.57,regular,606.85,
"Beijing Guoan @ 1.57
$27.00 Single",07/22/2018 6:19:38,27,42.43,15.43,CSL,1.57,regular,622.28,
"Beijing Guoan +0.5 @ 2.000
$12.28 Single",07/24/2018 21:03:45,12.28,0,-12.28,CSL,2,regular,610,
"Shanghai Shenhua 0.0,+0.5 @ 1.775
$50.00 Single",07/28/2018 6:55:38,50,69.38,19.38,CSL,1.775,regular,629.38,
"Shandong Luneng @ 1.66
$29.38 Single",07/30/2018 17:52:30,29.38,48.97,19.59,CSL,1.66,regular,648.97,
"Beijing Guoan -1.0 @ 1.900
$18.97 Single",08/02/2018 6:28:28,18.97,36.05,17.08,CSL,1.9,regular,666.05,
"Shandong Luneng 0.0,+0.5 @ 2.150
$26.05 Single",08/02/2018 17:34:06,26.05,41.03,14.98,CSL,2.15,regular,681.03,
"Shandong Luneng +0.5 @ 1.875
$20.00 Single",08/03/2018 20:05:16,20,37.5,17.5,CSL,1.875,regular,698.53,
"No @ 2.25
$30.00 Single",08/08/2018 21:00:48,30,67.5,37.5,CSL,2.25,both score,736.03,
"No @ 2.20
$28.53 Single",08/08/2018 21:03:20,28.53,62.77,34.24,CSL,2.2,both score,770.27,
"No @ 2.00
$30.00 Single",08/08/2018 22:49:12,30,30,0,CSL,2,both score,770.27,
"Beijing Renhe @ 2.10
$20.27 Single",08/11/2018 16:46:59,20.27,0,-20.27,CSL,2.1,regular,750,
"Shandong Luneng @ 7.00
$10.00 Single",08/13/2018 6:09:51,10,0,-10,CSL,7,regular,740,
"Under 3.0 @ 2.250
$30.00 Single",08/13/2018 17:38:35,30,30,0,CSL,2.25,goals,740,
"Under 3.0 @ 2.250
$30.00 Single",08/13/2018 19:26:09,30,30,0,CSL,2.25,goals,740,
"Tianjin Teda 0.0,+0.5 @ 1.875
$70.00 Single",08/13/2018 20:49:30,70,100.63,30.63,CSL,1.875,regular,770.63,
"PSG.LGD @ 1.50
$30.00 Single",08/14/2018 7:37:38,30,45,15,TI,1.5,regular,785.63,
"Under 101.5 @ 1.83
$30.00 Single",08/15/2018 6:45:07,30,0,-30,TI,1.83,goals,755.63,
"Tianjin Quanjian +2.5 @ 2.100
$15.63 Single",08/17/2018 8:19:04,15.63,0,-15.63,CSL,2.1,regular,740,
"Newbee @ 2.25
$20.00 Single",08/17/2018 14:24:19,20,0,-20,TI,2.25,regular,720,
"No @ 2.05
$30.00 Single",08/18/2018 6:32:12,30,0,-30,CSL,2.05,both score,690,
"Over 2.5 @ 1.600
$50.00 Single",08/20/2018 8:20:51,50,0,-50,CSL,1.6,goals,640,
"fnatic @ 1.57
$30.00 Single",08/20/2018 12:56:59,30,0,-30,TI,1.57,regular,610,
"PSG.LGD @ 1.80
$20.00 Single",08/20/2018 16:33:50,20,36,16,TI,1.8,regular,626,
"fnatic @ 1.66
$26.00 Single",08/20/2018 17:42:03,26,0,-26,TI,1.66,regular,600,
"Mineski @ 2.00
$30.00 Single",08/20/2018 19:29:29,30,60,30,TI,2,regular,630,
"Mineski @ 2.10
$30.00 Single",08/20/2018 19:30:06,30,63,33,TI,2.1,regular,663,
"Newbee @ 1.44
$23.00 Single",08/20/2018 20:57:43,23,0,-23,TI,1.44,regular,640,
"VGJ.Thunder @ 2.25
$30.00 Single",08/20/2018 22:30:51,30,0,-30,TI,2.25,regular,610,
"Over 2.5 @ 1.72
$20.00 Single",08/21/2018 6:37:14,20,0,-20,CSL,1.72,goals,590,
"Virtus Pro @ 12.00
$10.00 Single",08/22/2018 7:24:46,10,0,-10,TI,12,regular,580,
"Team Secret @ 1.72
$40.00 Single",08/22/2018 15:03:21,40,69.1,29.1,TI,1.72,regular,609.1,
"Team Secret @ 1.57
$50.00 Single",08/22/2018 15:24:32,50,0,-50,TI,1.57,regular,559.1,
"Team Secret @ 1.83
$50.00 Single",08/22/2018 17:47:19,50,91.67,41.67,TI,1.83,regular,600.77,
"Team Liquid @ 1.66
$20.00 Single",08/22/2018 20:22:49,20,0,-20,TI,1.66,regular,580.77,
"Team Liquid @ 1.90
$20.77 Single",08/22/2018 20:27:35,20.77,0,-20.77,TI,1.9,regular,560,
"OG @ 1.80
$20.00 Single",08/22/2018 23:40:58,20,0,-20,TI,1.8,regular,540,
"Team Secret @ 1.61
$30.00 Single",08/23/2018 17:21:59,30,48.47,18.47,TI,1.61,regular,558.47,
"Virtus Pro @ 1.83
$48.47 Single",08/23/2018 20:05:23,48.47,0,-48.47,TI,1.83,regular,510,
"Virtus Pro @ 2.00
$20.00 Single",08/23/2018 21:10:37,20,0,-20,TI,2,regular,490,
"OG @ 2.37
$20.00 Single",08/24/2018 17:18:20,20,0,-20,TI,2.37,regular,470,
"OG @ 2.50
$30.00 Single",08/24/2018 18:18:06,30,75,45,TI,2.5,regular,515,
"Evil Geniuses @ 2.00
$25.00 Single",08/24/2018 19:52:35,25,50,25,TI,2,regular,540,
"Evil Geniuses @ 1.90
$20.00 Single",08/24/2018 19:56:33,20,38.19,18.19,TI,1.9,regular,558.19,
"Team Liquid @ 1.57
$18.19 Single",08/24/2018 21:31:59,18.19,0,-18.19,TI,1.57,regular,540,
"Team Liquid @ 1.53
$20.00 Single",08/24/2018 21:34:09,20,0,-20,TI,1.53,regular,520,
"Under 3.0,3.5 @ 1.925
$30.00 Single",08/25/2018 6:27:34,30,0,-30,CSL,1.925,goals,490,
"Evil Geniuses @ 2.00
$20.00 Single",08/25/2018 12:58:14,20,0,-20,TI,2,regular,470,
"OG @ 2.25
$30.00 Single",08/25/2018 16:22:58,30,67.5,37.5,TI,2.25,regular,507.5,
"OG @ 2.20
$17.50 Single",08/25/2018 18:41:30,17.5,0,-17.5,TI,2.2,regular,490,
"PSG.LGD @ 1.40
$50.00 Single",08/25/2018 19:47:26,50,0,-50,TI,1.4,regular,440,
"Jiangsu Suning FC @ 1.50
$100.00 Single",08/29/2018 20:36:38,100,0,-100,CSL,1.5,regular,340,
"Shandong Luneng -0.5 @ 1.925
$50.00 Single",08/29/2018 20:38:43,50,50,0,CSL,1.925,regular,340,
"Shanghai SIPG -0.5,-1.0 @ 2.050
$50.00 Single",08/29/2018 20:55:55,50,0,-50,CSL,2.05,regular,290,
"Draw @ 5.00
$30.00 Single",09/13/2018 17:54:07,30,30,0,CSL,5,regular,290,
"Beijing Guoan @ 6.00
$20.00 Single",09/13/2018 17:54:19,20,20,0,CSL,6,regular,290,
"Beijing Guoan @ 6.00
$20.00 Single",09/13/2018 17:55:22,20,0,-20,CSL,6,regular,270,
"Beijing Guoan +1.0 @ 2.100
$30.00 Single",09/13/2018 17:55:35,30,30,0,CSL,2.1,regular,270,
"Draw @ 3.80
$30.00 Single",09/18/2018 6:26:58,30,30,0,CSL,3.8,regular,270,
"Shanghai SIPG @ 2.62
$30.00 Single",09/18/2018 6:30:58,30,30,0,CSL,2.62,regular,270,
"Shanghai SIPG 0.0 @ 1.925
$30.00 Single",09/18/2018 6:31:50,30,57.75,27.75,CSL,1.925,regular,297.75,
"Hebei CFFC -1.0 @ 1.975
$50.00 Single",09/20/2018 9:15:41,50,50,0,CSL,1.975,regular,297.75,
"Hebei CFFC -1.0 @ 1.925
$30.00 Single",09/21/2018 8:18:53,30,57.75,27.75,CSL,1.925,regular,325.5,
"Hebei CFFC @ 1.55
$20.00 Single",09/21/2018 8:19:06,20,31,11,CSL,1.55,regular,336.5,
"Under 2.5 @ 2.000
$16.50 Single",09/22/2018 22:46:56,16.5,0,-16.5,CSL,2,goals,320,
"Yes @ 1.72
$100.00 Single",09/26/2018 6:30:38,100,0,-100,CSL,1.72,both score,220,
"Arsenal @ 3.00
$20.00 Single",12/04/2018 18:36:51,20,0,-20,PL,3,regular,200,
"Arsenal @ 4.33
$10.00 Single",12/05/2018 16:24:18,10,0,-10,PL,4.33,regular,190,
"No @ 1.57
$20.00 Single",01/15/2019 17:46:54,20,31.43,11.43,AFC,1.57,both score,201.43,
"South Korea @ 1.57
$20.00 Single",01/15/2019 23:01:18,20,31.43,11.43,AFC,1.57,regular,212.86,
"China PR @ 2.00
$32.86 Single",01/17/2019 6:31:15,32.86,65.72,32.86,AFC,2,regular,245.72,
"Under 2.5 @ 1.57
$10.00 Single",01/19/2019 23:11:31,10,0,-10,AFC,1.57,goals,235.72,
"Under 2.0 @ 2.025
$10.00 Single",01/19/2019 23:11:53,10,0,-10,AFC,2.025,goals,225.72,
"No @ 1.75
$15.72 Single",01/21/2019 5:29:35,15.72,27.51,11.79,AFC,1.75,both score,237.51,
"No @ 1.75
$10.00 Single",01/21/2019 5:30:44,10,17.5,7.5,AFC,1.75,both score,245.01,
"Australia @ 1.95
$25.01 Single",01/21/2019 18:12:35,25.01,25.01,0,AFC,1.95,regular,245.01,
"Australia -0.5 @ 1.990
$20.00 Single",01/21/2019 18:13:23,20,0,-20,AFC,1.99,regular,225.01,
"Over 2.0 @ 1.775
$30.00 Single",01/23/2019 5:27:08,30,53.25,23.25,AFC,1.775,goals,248.26,
"Japan -1.5 @ 2.050
$20.00 Single",01/23/2019 21:15:44,20,0,-20,AFC,2.05,regular,228.26,
"Iran -0.5 @ 2.000
$25.01 Single",01/24/2019 10:17:41,25.01,50.02,25.01,AFC,2,regular,253.27,
"Japan 0.0,+0.5 @ 1.940
$23.27 Single",01/25/2019 9:58:35,23.27,45.15,21.88,AFC,1.94,regular,275.15,
"Japan 0.0,+0.5 @ 1.970
$10.00 Single",01/25/2019 13:38:24,10,19.7,9.7,AFC,1.97,regular,284.85,
"Japan 0.0,+0.5 @ 1.980
$20.00 Single",01/27/2019 8:33:53,20,39.6,19.6,AFC,1.98,regular,304.45,
"Over 2.0 @ 2.000
$14.45 Single",01/29/2019 8:58:27,14.45,28.9,14.45,AFC,2,goals,318.9,
"Japan 0.0,-0.5 @ 1.910
$20.00 Single",01/31/2019 17:29:32,20,20,0,AFC,1.91,regular,318.9,
"Japan 0.0,-0.5 @ 1.910
$27.10 Single",01/31/2019 18:37:49,27.1,27.1,0,AFC,1.91,regular,318.9,
"Japan -0.5 @ 1.775
$50.00 Single",02/01/2019 8:21:52,50,88.75,38.75,AFC,1.775,regular,357.65,
"Japan -0.5 @ 1.775
$7.10 Single",02/01/2019 8:27:07,7.1,12.61,5.51,AFC,1.775,regular,363.16,
"Atletico Madrid 0.0 @ 1.840
$21.36 Single",02/01/2019 23:09:37,21.36,39.31,17.95,UCL,1.84,regular,381.11,
"Real Madrid +0.5,+1.0 @ 1.900
$20.00 Single",02/06/2019 11:02:30,20,20,0,La Liga,1.9,regular,381.11,
"No @ 1.95
$20.00 Single",02/09/2019 4:31:32,20,0,-20,La Liga,1.95,both score,361.11,
"Man Utd 0.0,-0.5 @ 2.040
$50.00 Single",02/11/2019 15:04:38,50,0,-50,UCL,2.04,regular,311.11,
"Atletico Madrid 0.0 @ 2.040
$20.00 Single",02/19/2019 19:51:42,20,40.8,20.8,UCL,2.04,regular,331.91,
"Liverpool +0.5 @ 1.860
$20.00 Single",02/21/2019 0:00:47,20,20,0,PL,1.86,regular,331.91,
"Liverpool @ 1.90
$20.00 Single",02/24/2019 9:32:57,20,0,-20,PL,1.9,regular,311.91,
"Man City @ 1.30
$100.00 Single",02/24/2019 11:31:07,100,130,30,PL,1.3,regular,341.91,
"AC Milan 0.0 @ 2.125
$20.00 Single",02/25/2019 21:41:57,20,20,0,Serie A,2.125,regular,341.91,
"Tottenham 0.0,+0.5 @ 1.890
$30.00 Single",02/27/2019 9:30:21,30,0,-30,PL,1.89,regular,311.91,
"Real Madrid @ 2.10
$20.00 Single",02/27/2019 13:30:06,20,20,0,La Liga,2.1,regular,311.91,
"Under 3.0,3.5 @ 1.825
$20.00 Single",02/27/2019 13:30:32,20,28.25,8.25,Serie A,1.825,goals,320.16,
"Real Madrid 0.0 @ 2.080
$28.25 Single",03/01/2019 7:56:57,28.25,0,-28.25,La Liga,2.08,regular,291.91,
"Under 3.0,3.5 @ 1.910
$20.00 Single",03/01/2019 7:57:49,20,38.2,18.2,Serie A,1.91,goals,310.11,
"Arsenal @ 2.00
$30.00 Single",03/02/2019 7:54:43,30,0,-30,Serie A,2,regular,280.11,
"Real Madrid @ 5.00
$20.00 Single",03/02/2019 15:15:18,20,0,-20,La Liga,5,regular,260.11,
"Ajax +1.0 @ 1.910
$118.00 Single",03/05/2019 9:31:35,118,118,0,UCL,1.91,regular,260.11,
"Ajax +1.0 @ 1.800
$100.00 Single",03/05/2019 12:46:03,100,180,80,UCL,1.8,regular,340.11,
"Under 4.5 @ 1.72
$18.20 Single",03/06/2019 13:49:09,18.2,31.44,13.24,UCL,1.72,goals,353.35,
"FC Porto @ 2.00
$20.00 Single",03/06/2019 16:06:53,20,40,20,UCL,2,regular,373.35,
"Atletico Madrid +0.5,+1.0 @ 1.900
$21.44 Single",03/12/2019 14:01:49,21.44,0,-21.44,UCL,1.9,regular,351.91,
"Under 2.5 @ 2.010
$30.00 Single",03/13/2019 9:48:59,30,0,-30,UCL,2.01,goals,321.91,
"Lyon @ 13.00
$10.00 Single",03/13/2019 14:31:19,10,0,-10,UCL,13,regular,311.91,
"No @ 2.10
$10.00 Single",03/13/2019 14:31:52,10,0,-10,UCL,2.1,both score,301.91,
"No @ 2.10
$10.00 Single",03/13/2019 14:32:24,10,0,-10,UCL,2.1,both score,291.91,
"Ajax @ 3.60
$30.00 Single",03/18/2019 9:13:09,30,0,-30,UCL,3.6,regular,261.91,
"Ajax +0.5 @ 1.850
$50.00 Single",03/18/2019 9:13:25,50,92.5,42.5,UCL,1.85,regular,304.41,
"Ajax @ 3.50
$50.00 Single",04/08/2019 22:33:17,50,175,125,UCL,3.5,regular,429.41,
"Ajax @ 3.50
$20.00 Single",04/10/2019 15:17:34,20,0,-20,UCL,3.5,regular,409.41,
"Ajax @ 4.75
$22.50 Single",04/10/2019 20:21:12,22.5,106.88,84.38,UCL,4.75,regular,493.79,
"(0-0) Chelsea +0.5,+1.0 @ 1.970
$20.00 Single",04/14/2019 10:23:31,20,0,-20,PL,1.97,regular,473.79,
"Ajax @ 5.00
$20.00 Single",04/16/2019 15:19:56,20,100,80,PL,5,regular,553.79,
"Under 2.5 @ 1.990
$21.88 Single",04/17/2019 13:32:40,21.88,0,-21.88,UCL,1.99,goals,531.91,
"Liverpool +0.5,+1.0 @ 1.960
$50.00 Single",04/17/2019 20:23:34,50,0,-50,UCL,1.96,regular,481.91,
"Arsenal @ 1.95
$20.00 Single",04/18/2019 14:40:16,20,39.05,19.05,UCL,1.95,regular,500.96,
"No @ 1.95
$29.05 Single",04/19/2019 21:49:35,29.05,56.65,27.6,UCL,1.95,both score,528.56,
"Man City @ 1.44
$30.00 Single (10.00 Bet Credits + 20.00 CAD)",04/23/2019 9:30:45,30,43.34,13.34,PL,1.44,regular,541.9,
"Chelsea 0.0 @ 1.990
$20.00 Single",04/27/2019 19:10:22,20,20,0,PL,1.99,regular,541.9,
"Over 2.5 @ 1.90
$29.99 Single",04/28/2019 16:01:45,29.99,0,-29.99,PL,1.9,goals,511.91,
"Liverpool +0.5 @ 2.000
$20.00 Single",04/29/2019 22:43:35,20,0,-20,UCL,2,regular,491.91,
"Ajax @ 1.80
$20.00 Single",04/30/2019 13:38:51,20,0,-20,UCL,1.8,regular,471.91,
"Liverpool @ 2.05
$30.00 Single",05/01/2019 6:10:44,30,61.5,31.5,UCL,2.05,regular,503.41,
"Liverpool @ 11.00
$10.00 Single",05/01/2019 15:03:25,10,0,-10,UCL,11,regular,493.41,
"Beijing Guoan 0.0 @ 1.750
$40.00 Single",05/03/2019 22:42:58,40,70,30,CSL,1.75,regular,523.41,
"Arsenal +0.5 @ 1.975
$20.00 Single",05/05/2019 14:17:18,20,39.5,19.5,UCL,1.975,regular,542.91,
"Liverpool 0.0 @ 1.930
$20.00 Single",05/07/2019 12:58:04,20,38.6,18.6,UCL,1.93,regular,561.51,
"Liverpool @ 19.00
$10.00 Single",05/07/2019 12:58:26,10,190,180,UCL,19,regular,741.51,利物浦逆转巴萨，欧冠经典...
"Ajax @ 2.25
$10.10 Single",05/08/2019 13:52:09,10.1,0,-10.1,UCL,2.25,regular,731.41,
"Arsenal +0.5 @ 2.070
$30.00 Single",05/09/2019 13:31:20,30,62.1,32.1,UCL,2.07,regular,763.51,
"Leeds @ 1.72

$21.60 Single",05/15/2019 12:15:28,21.6,0,-21.6,PL,1.72,regular,741.91,
"Arsenal 0.0,+0.5 @ 1.800

$30.00 Single",05/27/2019 8:35:07,30,0,-30,UCL,1.8,regular,711.91,
"Arsenal +0.0 @ 2.05

$30.00 Single",05/27/2019 21:08:59,30,0,-30,UCL,2.05,regular,681.91,
"Arsenal 0.0,+0.5 @ 2.030

$20.00 Single",05/29/2019 6:33:18,20,0,-20,UCL,2.03,regular,661.91,
"Liverpool @ 1.90

$20.00 Single",06/01/2019 10:53:12,20,20,0,UCL,1.9,regular,661.91,
"Draw @ 4.33

$20.00 Single",06/01/2019 15:08:09,20,0,-20,UCL,4.33,regular,641.91,
"Holland 0.0,+0.5 @ 1.800

$100.00 Single",06/07/2019 9:14:14,100,0,-100,WWC,1.8,regular,541.91,
"No @ 2.00

$30.00 Single",06/07/2019 9:16:18,30,60,30,WWC,2,both score,571.91,
"Holland @ 3.00

$20.00 Single",06/07/2019 9:28:12,20,0,-20,WWC,3,regular,551.91,
"Holland +1.0 @ 2.00

$20.00 Single",06/09/2019 13:09:45,20,0,-20,WWC,2,regular,531.91,
"Holland @ 4.75

$10.00 Single",06/09/2019 14:47:56,10,0,-10,WWC,4.75,regular,521.91,
"Holland @ 21.00

$10.00 Single",06/09/2019 15:01:32,10,0,-10,WWC,21,regular,511.91,
"China PR Women @ 5.00

$20.00 Single",06/17/2019 8:22:13,20,0,-20,WWC,5,regular,491.91,
"France Women @ 3.60

$20.00 Single",06/24/2019 20:15:36,20,0,-20,WWC,3.6,regular,471.91,
"Germany Women @ 1.83

$30.00 Single",06/24/2019 20:15:43,30,0,-30,WWC,1.83,regular,441.91,
"Draw @ 3.75

$30.00 Single",06/25/2019 11:52:18,30,0,-30,WWC,3.75,regular,411.91,
"France Women 0.0,+0.5 @ 1.925

$20.00 Single",06/28/2019 8:38:03,20,0,-20,WWC,1.925,regular,391.91,
"Germany Women @ 1.61

$50.00 Single",06/29/2019 7:29:08,50,0,-50,WWC,1.61,regular,341.91,
"Germany Women @ 10.00

$20.00 Single",06/29/2019 12:53:19,20,0,-20,WWC,10,regular,321.91,
"Holland Women +1.0 @ 1.900

$30.00 Single",07/07/2019 9:09:16,30,0,-30,WWC,1.9,regular,291.91,
"Team Liquid @ 1.44

$20.00 Single",08/17/2019 5:38:42,20,28.89,8.89,TI,1.44,regular,300.8,
"Virtus Pro @ 2.62

$20.00 Single",08/19/2019 21:52:37,20,0,-20,TI,2.62,regular,280.8,
"PSG.LGD @ 1.44

$20.00 Single",08/19/2019 23:13:29,20,28.89,8.89,TI,1.44,regular,289.69,
"Royal Never Give Up @ 1.80

$20.00 Single",08/20/2019 5:25:44,20,36,16,TI,1.8,regular,305.69,
"Fnatic @ 2.37

$20.00 Single",08/20/2019 7:06:59,20,0,-20,TI,2.37,regular,285.69,
"TNC @ 1.66

$23.33 Single",08/21/2019 6:46:27,23.33,0,-23.33,TI,1.66,regular,262.36,
"Team Liquid @ 1.66

$20.45 Single",08/21/2019 7:55:40,20.45,34.09,13.64,TI,1.66,regular,276,
"Newbee @ 1.83

$34.09 Single",08/21/2019 22:21:36,34.09,62.5,28.41,TI,1.83,regular,304.41,
"Team Secret @ 1.50

$22.50 Single",08/22/2019 3:34:11,22.5,33.75,11.25,TI,1.5,regular,315.66,
"Vici Gaming @ 2.10

$23.75 Single",08/22/2019 5:04:41,23.75,0,-23.75,TI,2.1,regular,291.91,
"Vici Gaming @ 2.00

$50.00 Single",08/22/2019 6:19:29,50,0,-50,TI,2,regular,241.91,
"OG @ 1.72

$30.00 Single",08/22/2019 8:52:01,30,51.82,21.82,TI,1.72,regular,263.73,
"OG @ 1.80

$21.82 Single",08/22/2019 10:06:48,21.82,39.28,17.46,TI,1.8,regular,281.19,
"Team Liquid @ 1.50

$100.00 Single",08/22/2019 22:34:44,100,150,50,TI,1.5,regular,331.19,
"Vici Gaming @ 2.10

$39.28 Single",08/23/2019 21:24:47,39.28,0,-39.28,TI,2.1,regular,291.91,
"Vici Gaming @ 1.83

$50.00 Single",08/23/2019 22:21:57,50,0,-50,TI,1.83,regular,241.91,
"Vici Gaming @ 1.83

$50.00 Single",08/23/2019 22:24:08,50,0,-50,TI,1.83,regular,191.91,
"OG @ 2.00

$50.00 Single",08/23/2019 23:31:30,50,0,-50,TI,2,regular,141.91,
"Shanghai Shenhua +2.5 @ 1.875

$20.00 Single",11/30/2019 23:41:58,20,0,-20,CSL,1.875,regular,121.91,
"Man City @ 1.30

$100.00 Single",12/05/2019 10:33:58,100,0,-100,PL,1.3,regular,21.91,
"Inter Milan -1.0 @ 1.980

$30.00 Single",12/09/2019 10:18:17,30,0,-30,UCL,1.98,regular,-8.09,
"Real Madrid @ 3.10

$20.00 Single",12/18/2019 11:42:29,20,62,42,La Liga,3.1,corner,33.91,
"Real Madrid +2.0 @ 1.83

$30.00 Single",12/18/2019 11:42:39,30,30,0,La Liga,1.83,corner,33.91,
"Real Madrid @ 3.50

$20.00 Single",12/18/2019 14:31:04,20,0,-20,La Liga,3.5,live,13.91,
"Juventus @ 2.05

$22.00 Single",12/21/2019 21:22:23,22,0,-22,Serie A,2.05,regular,-8.09,
"Leicester +0.5 @ 1.940

$20.00 Single",12/26/2019 15:00:37,20,0,-20,PL,1.94,regular,-28.09,
"Under 3.0 @ 2.030

$30.00 Single",12/27/2019 14:32:23,30,0,-30,PL,2.03,goal,-58.09,
"Wolverhampton or Draw @ 2.75

$50.00 Single",12/27/2019 16:05:10,50,137.5,87.5,PL,2.75,live,29.41,
"Wolverhampton or Draw @ 3.25

$50.00 Single",12/27/2019 16:21:02,50,162.5,112.5,PL,3.25,live,141.91,
"Chelsea 0.0,-0.5 @ 2.070

$20.00 Single",12/27/2019 18:03:34,20,41.4,21.4,PL,2.07,regular,163.31,
"Over 2.5 @ 1.53

$20.00 Single",12/28/2019 21:38:07,20,30.67,10.67,PL,1.53,goal,173.98,
"Over 2.5,3.0 @ 1.860

$20.00 Single",12/29/2019 8:55:09,20,28.6,8.6,PL,1.86,goal,182.58,
"Chelsea or Draw @ 3.00

$40.00 Single",12/29/2019 10:28:50,40,120,80,PL,3,live,262.58,
"Wolverhampton or Draw @ 3.40

$20.67 Single",12/29/2019 12:06:12,20.67,0,-20.67,PL,3.4,live,241.91,
"Brescia +1.0 @ 1.920

$20.00 Single",01/03/2020 21:33:44,20,20,0,,1.92,,241.91,
"Southampton +1.0 @ 2.020

$20.00 Single",01/03/2020 21:36:40,20,40.4,20.4,,2.02,,262.31,
"Real Madrid @ 1.83

$20.00 Single",01/04/2020 10:19:10,20,36.67,16.67,,1.83,,278.98,
"Espanyol @ 2.87

$16.67 Single",01/04/2020 15:39:50,16.67,0,-16.67,,2.87,,262.31,
"Napoli 0.0,+0.5 @ 2.100

$40.00 Single",01/10/2020 6:57:53,40,40,0,,2.1,,262.31,
"Southampton +0.5,+1.0 @ 2.090

$20.00 Single",01/11/2020 0:06:33,20,41.8,21.8,,2.09,,284.11,
"(0-0) Napoli +0.5 @ 1.900

$40.00 Single",01/11/2020 11:51:05,40,0,-40,,1.9,,244.11,
"Draw @ 6.50

$12.20 Single",01/11/2020 14:09:20,12.2,0,-12.2,,6.5,,231.91,
"Atalanta @ 6.00

$10.00 Single",01/11/2020 16:26:35,10,0,-10,,6,,221.91,
"Real Madrid 0.0,-0.5 @ 2.070

$20.00 Single",01/12/2020 12:55:15,20,10,-10,,2.07,,211.91,
"Roma or Draw @ 3.40

$30.00 Single",01/12/2020 16:17:38,30,0,-30,,3.4,,181.91,
"Sampdoria +1.0,+1.5 @ 1.980

$40.00 Single",01/14/2020 17:14:28,40,0,-40,,1.98,,141.91,
"Inter Milan @ 1.66

$60.00 Single",01/19/2020 10:26:04,60,0,-60,,1.66,,81.91,
"Chelsea @ 1.72

$20.00 Single",01/21/2020 14:40:57,20,0,-20,,1.72,,61.91,
"Chelsea @ 1.80

$180.00 Single",01/21/2020 15:25:29,180,0,-180,,1.8,,-118.09,
"Valencia @ 1.72

$100.00 Single",01/25/2020 11:20:14,100,172.73,72.73,,1.72,,-45.36,
"Roma -1.0 @ 2.30

$22.73 Single",01/26/2020 11:17:33,22.73,52.28,29.55,,2.3,,-15.81,
"Roma 0.0,+0.5 @ 1.820

$50.00 Single",01/26/2020 11:17:48,50,70.5,20.5,,1.82,,4.69,
"Roma @ 2.75

$50.00 Single",01/26/2020 13:13:34,50,0,-50,,2.75,,-45.31,
"Real Madrid -0.5 @ 1.870

$22.78 Single",02/01/2020 9:22:39,22.78,42.6,19.82,,1.87,,-25.49,
"Real Madrid @ 2.37

$160.00 Single",02/01/2020 11:05:36,160,321.54,161.54,La Liga,2.37,,136.05,Real Madrid v Atletico Madrid(Fulltime Result)
"Burnley @ 4.00

$14.41 Single",02/02/2020 10:13:19,14.41,0,-14.41,,4,,121.64,
"Tottenham +1.0 @ 2.040

$19.73 Single",02/02/2020 11:07:27,19.73,40.25,20.52,,2.04,,142.16,
"Tottenham or Draw @ 2.10

$30.00 Single",02/02/2020 12:14:43,30,63,33,,2.1,,175.16,
"Inter Milan -0.5 @ 1.990

$33.25 Single",02/07/2020 20:15:04,33.25,66.17,32.92,,1.99,,208.08,
"Atalanta -0.5 @ 1.950

$20.00 Single",02/08/2020 8:27:42,20,39,19,,1.95,,227.08,
"Atalanta -1.0 @ 1.90

$20.00 Single",02/08/2020 8:33:36,20,0,-20,,1.9,,207.08,
"Inter Milan -0.5 @ 2.000

$39.00 Single",02/09/2020 9:36:34,39,78,39,,2,,246.08,
"Parma @ 19.00

$10.00 Single",02/09/2020 13:08:29,10,0,-10,,19,,236.08,
"Inter Milan -0.5 @ 2.125

$20.00 Single",02/09/2020 14:04:06,20,42.5,22.5,,2.125,,258.58,
"Inter Milan @ 2.50

$20.00 Single",02/09/2020 16:01:54,20,50,30,,2.5,,288.58,
"Inter Milan -0.5 @ 2.025

$16.67 Single",02/12/2020 14:11:44,16.67,0,-16.67,,2.025,,271.91,
"Getafe -1.0 @ 2.100

$20.00 Single",02/15/2020 9:38:08,20,0,-20,,2.1,,251.91,
"Inter Milan 0.0,+0.5 @ 1.820

$80.00 Single",02/16/2020 13:50:51,80,80,0,,1.82,,251.91,
"Inter Milan @ 2.90

$30.00 Single",02/16/2020 13:58:10,30,0,-30,,2.9,,221.91,
"Inter Milan 0.0 @ 2.125

$50.00 Single",02/16/2020 14:17:21,50,0,-50,,2.125,,171.91,
"Inter Milan 0.0 @ 2.125

$100.00 Single",02/16/2020 14:18:06,100,0,-100,Serie A,2.125,regular,71.91,Lazio v Inter Milan(Asian Handicap)
"Inter Milan @ 3.40

$50.00 Single",02/16/2020 15:58:29,50,0,-50,,3.4,,21.91,
"Inter Milan @ 26.00

$20.00 Single",02/16/2020 16:18:59,20,0,-20,,26,,1.91,
"Liverpool @ 2.25

$30.00 Single",02/18/2020 7:57:23,30,0,-30,,2.25,,-28.09,
"Liverpool 0.0,-0.5 @ 2.000

$100.00 Single",02/18/2020 8:12:48,100,0,-100,,2,,-128.09,
"Liverpool @ 9.50

$20.00 Single",02/18/2020 16:13:46,20,0,-20,,9.5,,-148.09,
"Atalanta to score 3rd goal @ 1.83

$30.00 Single",02/19/2020 16:07:42,30,55,25,,1.83,,-123.09,
"Atalanta to score 5th goal @ 2.25

$15.00 Single",02/19/2020 16:24:09,15,0,-15,,2.25,,-138.09,
"Draw @ 7.00

$10.00 Single",02/19/2020 16:44:45,10,0,-10,,7,,-148.09,
"Man City -1.0 @ 2.010

$30.00 Single",02/22/2020 12:04:25,30,30,0,,2.01,,-148.09,
"Napoli -1.0 @ 2.75

$180.00 Single",02/25/2020 9:24:13,180,180,0,,2.75,,-148.09,
"Napoli -1.0 @ 2.75

$80.00 Single",02/25/2020 14:01:07,80,0,-80,,2.75,,-228.09,
"Man City @ 2.30

$100.00 Single",02/26/2020 14:12:57,100,100,0,,2.3,,-228.09,
"Man City -1.0 @ 1.900

$50.00 Single",02/26/2020 14:33:31,50,95,45,,1.9,,-183.09,
"Man City 0.0,-0.5 @ 2.020

$50.00 Single",02/26/2020 14:34:03,50,101,51,,2.02,,-132.09,
"Man City @ 2.60

$30.00 Single",02/26/2020 16:10:58,30,78,48,,2.6,,-84.09,
"Man City @ 8.00

$70.00 Single",02/26/2020 16:19:19,70,560,490,UCL,8,live,405.91,"Man City vs Real Madrid
热苏斯超神，看准了就是吃"
"Ludogorets Razgrad +1.0,+1.5 @ 2.040

$34.00 Single",02/27/2020 14:18:24,34,51.68,17.68,,2.04,,423.59,
"Bologna +1.0 @ 1.970

$21.68 Single",02/29/2020 8:19:21,21.68,0,-21.68,,1.97,,401.91,
"Bologna to score 3rd goal @ 2.50

$30.00 Single",02/29/2020 10:19:38,30,0,-30,,2.5,,371.91,
"Real Madrid 0.0,-0.5 @ 2.010

$50.00 Single",03/01/2020 14:08:38,50,100.5,50.5,,2.01,,422.41,"Real Madrid vs Barc
吃!"
"Real Madrid 0.0,-0.5 @ 2.010
$60.00 Single
",03/01/2020 14:10:03,60,120.6,60.6,,2.01,,483.01,"Real Madrid vs Barc
吃!"
"Real Madrid @ 2.87

$30.00 Single",03/01/2020 16:15:54,30,86.25,56.25,,2.87,,539.26,"Real Madrid vs Barc
吃!"
"Man City to score 2nd goal @ 1.83

$27.35 Single",03/08/2020 12:47:50,27.35,0,-27.35,,1.83,,511.91,
"Inter Milan 0.0,+0.5 @ 2.040

$20.00 Single",03/08/2020 14:10:27,20,0,-20,,2.04,,491.91,
"Inter Milan to score 2nd goal @ 2.62

$20.00 Single",03/08/2020 15:56:17,20,0,-20,,2.62,live goal,471.91,
"Tottenham @ 6.00

$20.00 Single",03/10/2020 14:58:46,20,0,-20,,6,,451.91,
"Tottenham @ 51.00

$10.00 Single",03/10/2020 16:08:22,10,0,-10,,51,,441.91,
"Over 2.5 @ 1.990

$30.00 Single",03/11/2020 14:54:33,30,0,-30,,1.99,,411.91,
"Over 2.5 @ 1.990

$20.00 Single",03/11/2020 14:55:16,20,0,-20,,1.99,,391.91,
"Over 2.5 @ 1.990

$20.00 Single",03/11/2020 14:57:22,20,0,-20,,1.99,,371.91,
"Atletico Madrid to score 2nd goal @ 8.50

$20.00 Single",03/11/2020 16:31:55,20,0,-20,,8.5,,351.91,
"Sevilla @ 5.50

$20.00 Single",06/19/2020 16:33:03,20,0,-20,La Liga,5.5,,331.91,
"(0-0) Real Madrid -0.5,-1.0 @ 1.930

$60.00 Single",06/21/2020 15:04:23,60,106.98,46.98,La Liga,1.93,,378.89,
"Atalanta @ 2.10

$26.98 Single",06/23/2020 5:01:31,26.98,56.66,29.68,Serie A,2.1,,408.57,"Atalanta vs Lazio
拉齐奥复赛第一场，看出完全
是XJBT, 果然被逆转"
"Atalanta 0.0,-0.5 @ 2.010

$30.00 Single",06/24/2020 14:42:41,30,60.3,30.3,Serie A,2.01,,438.87,"Atalanta vs Lazio
拉齐奥复赛第一场，看出完全
是XJBT, 果然被逆转"
"Atalanta @ 4.75

$20.00 Single",06/24/2020 15:59:26,20,95,75,Serie A,4.75,,513.87,"Atalanta vs Lazio
拉齐奥复赛第一场，看出完全
是XJBT, 果然被逆转"
"Man City @ 2.10

$21.96 Single",06/25/2020 15:28:26,21.96,0,-21.96,PL,2.1,,491.91,
"Real Madrid -1.0 @ 1.850

$50.00 Single",06/28/2020 11:24:37,50,50,0,La Liga,1.85,,491.91,
"Real Madrid -1.0 @ 1.860

$70.00 Single",06/28/2020 11:26:18,70,70,0,La Liga,1.86,,491.91,
"Atletico Madrid +0.5 @ 2.030

$100.00 Single",06/29/2020 18:59:25,100,94.42,-5.58,La Liga,2.03,,486.33,
"Atletico Madrid +0.5,+1.0 @ 1.950

$114.42 Single",06/30/2020 12:05:07,114.42,223.12,108.7,La Liga,1.95,,595.03,"马竞 vs Barcelona
巴萨本赛季送钱童子，看准了
就是是吃"
"Draw @ 5.50

$20.00 Single",06/30/2020 16:14:54,20,110,90,La Liga,5.5,live goal,685.03,
"Atletico Madrid to score 5th goal @ 6.00

$10.00 Single",06/30/2020 16:41:17,10,0,-10,La Liga,6,live goal,675.03,
"Man City to score 2nd goal @ 1.95

$23.12 Single",07/02/2020 14:45:49,23.12,45.14,22.02,PL,1.95,live,697.05,"Man City vs Liverpool
利物浦已夺冠，欧冠已被淘汰
战意决定一切
尤文意甲夺冠后最后几轮也是拉胯"
"Real Madrid @ 1.80

$15.14 Single",07/02/2020 15:22:01,15.14,27.26,12.12,La Liga,1.8,live,709.17,
"Real Madrid @ 2.40

$20.00 Single",07/02/2020 16:23:30,20,48,28,La Liga,2.4,live,737.17,
"Juventus 0.0,-0.5 @ 2.030

$25.26 Single",07/07/2020 15:03:28,25.26,0,-25.26,Serie A,2.03,,711.91,"Juventus vs Milan
米兰4球逆转，坑爹"
"Napoli 0.0,-0.5 @ 1.870

$40.00 Single",07/11/2020 10:00:56,40,20,-20,Serie A,1.87,,691.91,
"Atalanta 0.0,+0.5 @ 2.040

$50.00 Single",07/11/2020 14:38:03,50,76,26,Serie A,2.04,regular,717.91,"Atalanta vs Juventus
尤文两个点球坑爹"
"Atalanta @ 5.00

$10.00 Single",07/11/2020 16:16:23,10,0,-10,Serie A,5,live,707.91,"Atalanta vs Juventus
尤文两个点球坑爹"
"Napoli @ 2.20

$30.00 Single",07/12/2020 14:49:54,30,0,-30,Serie A,2.2,,677.91,
"Napoli @ 3.75

$36.00 Single",07/12/2020 15:09:05,36,99,63,Serie A,3.75,live,740.91,"Napoli vs AC Milan
米兰又是坑爹点球扳平. 幸好滚球提前cash out, 策略正确"
"Southampton @ 34.00

$9.00 Single",07/13/2020 15:12:29,9,0,-9,PL,34,,731.91,
"Man City @ 4.75

$20.00 Single",07/18/2020 15:10:36,20,0,-20,PL,4.75,,711.91,
"Bologna to score 4th goal @ 3.40

$40.00 Single",07/18/2020 15:32:01,40,0,-40,Serie A,3.4,live goal,671.91,
"Juventus to score 3rd goal @ 2.40

$30.00 Single",07/20/2020 16:18:56,30,0,-30,Serie A,2.4,live goal,641.91,
"Sassuolo +0.5,+1.0 @ 1.940

$20.00 Single",07/21/2020 14:40:49,20,10,-10,Serie A,1.94,,631.91,
"Sassuolo @ 4.33

$20.00 Single",07/21/2020 15:30:12,20,0,-20,Serie A,4.33,,611.91,
"Atalanta 0.0,-0.5 @ 1.980

$40.00 Single",07/23/2020 14:25:03,40,20,-20,Serie A,1.98,,591.91,
"Atalanta -1.0 @ 2.37

$50.00 Single",07/23/2020 14:25:54,50,118.75,68.75,Serie A,2.37,corner,660.66,"
AC Milan v Atalanta(Corner Handicap)
角球大数据"
"Atalanta @ 2.25

$30.00 Single",07/24/2020 15:23:37,30,0,-30,Serie A,2.25,,630.66,
"Atalanta @ 2.75

$20.00 Single",07/24/2020 16:01:23,20,0,-20,Serie A,2.75,,610.66,
"Atalanta @ 2.87

$50.00 Single",07/24/2020 16:05:28,50,0,-50,Serie A,2.87,,560.66,
"No @ 1.80

$38.75 Single",07/26/2020 9:49:19,38.75,69.75,31,PL,1.8,,591.66,"Chelsea v Wolverhampton(Both Teams to Score)
英超最后一轮, 切尔西争欧冠席位, 打平即可.谨慎为上"
"Inter Milan to score 2nd goal @ 2.50

$29.75 Single",07/28/2020 16:12:06,29.75,74.38,44.63,Serie A,2.5,,636.29,
"Atalanta to score 3rd goal @ 2.75

$24.38 Single",08/01/2020 15:13:47,24.38,0,-24.38,Serie A,2.75,,611.91,
"Getafe @ 3.20

$50.00 Single",08/04/2020 12:32:35,50,160,110,UCL,3.2,corner,721.91,"Getafe vs Inter
角球大数据精准命中 (Cross + Corner)"
"Getafe to score 2nd goal @ 3.60

$20.00 Single",08/05/2020 15:16:26,20,0,-20,UCL,3.6,live goal,701.91,"Getafe vs Inter

本来应该命中的，可惜点球发丢了"
"Getafe to score 2nd goal @ 4.33

$20.00 Single",08/05/2020 15:28:53,20,0,-20,UCL,4.33,live goal,681.91,"Getafe vs Inter

本来应该命中的，可惜点球发丢了"
"Lyon +1.0 @ 1.970

$60.00 Single",08/07/2020 13:02:18,60,60,0,UCL,1.97,,681.91,"Lyon vs Juventus
欧冠16进8， Lyon半年没正式比赛了
尤文依然拉胯, 可见意甲的强度之低"
"Man City to score 4th goal @ 2.10

$20.00 Single",08/07/2020 15:32:40,20,0,-20,UCL,2.1,,661.91,"Man City vs Real Madrid
欧冠16进8， 拉莫斯停赛。瓦拉内2次低级失误。
强调中卫组合稳定性
偶联Roma vs Sevilla也验证了这一点(Smalling缺阵)"
"Napoli +1.0 @ 2.000

$40.00 Single",08/08/2020 13:59:47,40,80,40,,2,corner,701.91,"Barcelona v Napoli
这个角球还是很稳的..."
"Napoli to score 5th goal @ 3.75

$20.00 Single",08/08/2020 15:36:34,20,0,-20,,3.75,,681.91,
"Man City -1.5 @ 1.930

$30.00 Single",08/08/2020 19:15:12,30,31.59,1.59,,1.93,,683.5,
"Bayern Munich @ 1.95

$30.00 Single",08/10/2020 10:04:39,30,30,0,,1.95,cash out,683.5,
"Bayern Munich -0.5 @ 2.020

$50.00 Single",08/10/2020 10:05:14,50,101,51,UCL,2.02,,734.5,"拜仁 vs 巴萨
看了一赛季巴萨，结果并不意外，最稳的一场"
"Bayern Munich -0.5 @ 2.020

$50.00 Single",08/10/2020 10:05:41,50,101,51,UCL,2.02,,785.5,拜仁 vs 巴萨
"Over 2.0 @ 2.000

$30.00 Single",08/11/2020 10:29:22,30,0,-30,UCL,2,goal,755.5,Wolverhampton v Sevilla(Goal Line)
"Over 2.0 @ 2.100

$20.00 Single",08/11/2020 13:28:07,20,0,-20,UCL,2.1,goal,735.5,"Wolverhampton v Sevilla(Goal Line)
这个参考两队数据应该可以看出端倪:
狼队龟缩，火力不强"
"Over 1.0,1.5 @ 2.150

$38.00 Single",08/12/2020 14:00:08,38,41.24,3.24,,2.15,goal,738.74,"Atalanta vs Paris
半场大小球"
"Over 1.0,1.5 @ 2.150

$12.00 Single",08/12/2020 14:00:22,12,6,-6,UCL,2.15,goal,732.74,
"Atalanta to score 2nd goal @ 3.00

$27.24 Single",08/12/2020 15:07:02,27.24,0,-27.24,UCL,3,,705.5,
"Atalanta to score 2nd goal @ 4.33

$20.00 Single",08/12/2020 15:33:15,20,0,-20,UCL,4.33,,685.5,
"Atletico Madrid to score 3rd goal @ 4.33

$20.00 Single",08/13/2020 15:38:58,20,0,-20,UCL,4.33,,665.5,
"Atletico Madrid to score 3rd goal @ 4.33

$10.00 Single",08/13/2020 15:39:30,10,0,-10,UCL,4.33,,655.5,
"Bayern Munich -0.5 @ 2.000

$100.00 Single",08/13/2020 22:39:11,100,200,100,UCL,2,,755.5,"拜仁 vs 巴萨
看了一赛季巴萨，结果并不意外，最稳的一场"
"Bayern Munich to score 8th goal @ 2.10

$50.00 Single",08/14/2020 15:29:43,50,105,55,UCL,2.1,live goal,810.5,"拜仁 vs 巴萨
最后莱万还没进，所以来了第8个..."
"Sevilla 0.0 @ 2.000

$57.00 Single",08/15/2020 9:32:34,57,0,-57,,2,,753.5,
"Man City @ 3.75

$31.59 Single",08/15/2020 15:18:17,31.59,0,-31.59,,3.75,,721.91,
"Beijing Guoan to score 6th goal @ 1.80

$100.00 Single",08/16/2020 6:27:34,100,0,-100,CSL,1.8,,621.91,中超赛季处子秀，卒
"Man Utd @ 2.40

$200.00 Single",08/16/2020 15:21:09,200,0,-200,UCL,2.4,,421.91,被曼城搞了心态，崩
"Inter Milan to score 3rd goal @ 2.20

$200.00 Single",08/17/2020 15:23:00,200,440,240,UCL,2.2,live goal,661.91,"Inter Milan v Shakhtar Donetsk
曼城把心态搞崩了，孤注一掷. 
根据矿工之前打亚特兰大的拉胯后防最后崩盘判定其还会继续丢球，最后果然再丢三个"
"Draw @ 4.00

$40.00 Single",08/18/2020 11:09:41,40,0,-40,UCL,4,,621.91,"Paris vs LPZ
不看好巴黎，博个平局"
"Bayern Munich -0.5 @ 1.950

$200.00 Single",08/19/2020 16:19:02,200,200,0,UCL,1.95,,621.91,
"Bayern Munich -0.5 @ 1.950

$100.00 Single",08/19/2020 16:20:16,100,195,95,UCL,1.95,regular,716.91,"欧冠决赛,赛季的完美句号
巴黎毫无胜算，决赛资金量大, 小注规避风险"
"Sevilla 0.0,+0.5 @ 1.925

$100.00 Single",08/21/2020 12:32:47,100,192.5,92.5,UCL,1.925,regular,809.41,"欧联决赛, Sevilla vs Inter
国米赛前赔率显示为优势. 
一个赛季意甲没白看, 拉胯联赛，孔蒂垃圾"
"Sevilla to score 5th goal @ 4.33

$50.00 Single",08/21/2020 15:28:04,50,216.67,166.67,UCL,4.33,live goal,976.08,"欧联决赛, Sevilla vs Inter
国米赛前赔率显示为优势. 
一个赛季意甲没白看, 拉胯联赛，孔蒂垃圾"
"Bayern Munich -0.5 @ 2.070

$79.17 Single
",08/21/2020 19:23:25,79.17,143.89,64.72,UCL,2.07,regular,1040.8,
"Bayern Munich -2.0 @ 1.975

$50.00 Single",08/23/2020 13:11:01,50,0,-50,UCL,1.975,corner,990.8,欧冠决赛，这个角球没打出比较意外
"Shandong Luneng -0.5 @ 1.875

$38.89 Single",08/29/2020 6:58:45,38.89,0,-38.89,,1.875,,951.91,
"Leeds @ 10.00

$50.00 Single",09/06/2020 9:39:47,50,0,-50,PL,10,,901.91,"Leeds vs Liverpool
庆祝Leeds联重返英超, 情怀一注只为支持贝尔萨"
"Everton @ 4.75

$20.00 Single",09/13/2020 11:34:57,20,95,75,,4.75,,976.91,
"Dalian Pro @ 1.83

$25.00 Single",09/14/2020 7:12:54,25,0,-25,,1.83,,951.91,
"Liverpool 0.0,-0.5 @ 1.980

$50.00 Single",09/20/2020 6:31:47,50,99,49,,1.98,,1000.91,
"Liverpool @ 2.20

$50.00 Single",09/20/2020 11:08:35,50,110,60,,2.2,,1060.91,
"Man City -1.0 @ 1.870

$29.00 Single",09/21/2020 14:11:12,29,54.23,25.23,,1.87,,1086.14,
"Atalanta 0.0 @ 1.950

$50.00 Single",09/29/2020 8:36:12,50,97.5,47.5,,1.95,,1133.64,
"Leeds +1.5 @ 1.940

$34.23 Single",09/30/2020 5:26:56,34.23,66.41,32.18,,1.94,,1165.82,
"Borussia Dortmund to score 5th goal @ 3.40

$50.00 Single",09/30/2020 14:52:58,50,0,-50,,3.4,,1115.82,
"Leeds @ 21.00

$17.50 Single",10/03/2020 12:36:23,17.5,0,-17.5,,21,,1098.32,
"Borussia Dortmund 0.0,-0.5 @ 1.980

$96.41 Single",10/07/2020 7:11:42,96.41,0,-96.41,UCL,1.98,regular,1001.91,"Lazio vs Dortmund, 大崩盘的第二场
提前投注, 以当时的眼光来看，这赔率真TMD就是白送"
"Beijing Guoan @ 3.00

$20.00 Single",10/17/2020 4:00:31,20,0,-20,,3,,981.91,
"Inter Milan -0.5 @ 2.080

$80.00 Single",10/17/2020 10:28:29,80,0,-80,,2.08,,901.91,"Inter vs AC Milan
有三支球队我是长期做空的: 拉齐奥, 热刺(穆里尼奥), 米兰(伊布). 坚决做空米兰因为伊布的球风和跑动能力. 结果米兰本赛季意甲10轮后排名第一，脸都给我打肿了
恰好碰上我在意甲无脑做多的国际米兰(英超班子, 劳塔罗). 孔蒂真心是坑爹, 本赛季可能要粉转黑"
"Inter Milan @ 3.40

$50.00 Single",10/17/2020 11:36:00,50,0,-50,,3.4,,851.91,
"Shanghai SIPG -1.0 @ 1.800

$150.00 Single",10/17/2020 18:58:53,150,0,-150,CSL,1.8,,701.91,"上港vs申花, 大崩盘的开始
投注依据：中超靠外援, 上港有新晋英超大腿外援，申花只有双外援, 上港常规赛数据全面占优
主要问题: 没认真看过两队的比赛, 完全不了解上港队内的一些问题(事后才知道有外援续约，降薪和态度问题)"
"Shanghai SIPG -1.0 @ 1.975

$100.00 Single",10/18/2020 6:21:23,100,0,-100,CSL,1.975,,601.91,"上港vs申花, 大崩盘的开始"
"Borussia Dortmund 0.0,-0.5 @ 1.860

$100.00 Single",10/18/2020 10:56:35,100,0,-100,UCL,1.86,regular,501.91,"Lazio vs Dortmund, 大崩盘的第二场
拉齐奥十年后重返欧冠第一场，我最熟悉的意甲养老队面对一只常年和拜仁打高强度对抗的球队居然都会爆冷...

反思：多特蒙德的比赛我没看过，没想到如此拉垮. 当然这场球问我依然觉得有问题"
"Man Utd 0.0 @ 1.880

$50.00 Single",10/24/2020 10:42:23,50,50,0,,1.88,,501.91,
"Lazio 0.0,+0.5 @ 2.040

$30.00 Single",10/28/2020 14:34:53,30,30.47,0.47,UCL,2.04,cancelled,502.38,"拉齐奥的比赛还是少碰吧, 假成马"
"Barcelona to score 2nd goal @ 2.50

$30.47 Single",10/28/2020 16:24:24,30.47,76.18,45.71,UCL,2.5,live goal,548.09,"巴萨对尤文, 很难得能重一次live goal. 2.5的赔率回看起来还是不划算的(从概率来看3.0+才是一个合理的赔率. 后30分钟进球概率40% / 1.5 = 0.26)"
"Jiangsu Suning FC @ 3.60

$26.18 Single",10/29/2020 7:06:08,26.18,0,-26.18,CSL,3.6,,521.91,苏宁 vs 上港
"Man Utd @ 2.25

$20.00 Single",11/01/2020 12:02:15,20,0,-20,,2.25,,501.91,
"Man Utd to score 2nd goal @ 2.87

$20.00 Single",11/01/2020 13:04:22,20,0,-20,,2.87,,481.91,
"Leeds @ 7.50

$30.00 Single",11/02/2020 16:07:09,30,0,-30,,7.5,,451.91,
"Real Madrid -0.5 @ 2.020

$50.00 Single",11/03/2020 14:16:57,50,101,51,UCL,2.02,,502.91,"Real Madrid vs Inter Milan
孔蒂傻逼，齐达内牛逼, 买就是了. 这就是我的偏执"
"Donald Trump @ 11.00

$11.00 Single",11/05/2020 17:49:13,11,0,-11,,11,,491.91,
"Man City -0.5,-1.0 @ 2.070

$90.00 Single",11/21/2020 12:17:40,90,0,-90,PL,2.07,,401.91,"Tottenam vs Man city.
我对穆里尼奥有很大的偏见, 外加偏爱瓜迪奥拉, 所以这种失败不可避免

这个赛季曼城进攻端问题较大，这个我已经看出来，这场的注码买的是一个瓜迪奥拉刚刚续约（士气++), 这场投注应该控制在50以内"
"Man City @ 4.50

$50.00 Single",11/21/2020 13:49:18,50,0,-50,,4.5,live,351.91,"Tottenam vs Man city.
曼城落后以后心态炸裂... 足球比赛逆转的概率究竟有多大? "
"Barcelona @ 8.50

$50.00 Single",11/21/2020 16:17:24,50,0,-50,,8.5,,301.91,
"Leeds @ 3.25

$100.00 Single",11/22/2020 11:37:21,100,0,-100,PL,3.25,regular,201.91,"Leeds vs Arsenal
让我直接原地爆炸的一场. Leeds全场压制, 浪射无数, 阿森纳下半场还被罚下一人...
这场复盘没有问题, 虽然我已输的怀疑人生"
"Leeds @ 3.00

$50.00 Single",11/28/2020 13:30:15,50,150,100,PL,3,regular,301.91,"Everton vs Leeds
赛季Leeds比赛一场不落， 对两队都比较了解
当然投注Leeds主要还是情怀考虑. 这个队的问题就是练的太猛, 打法消耗太大,感觉赛季中期随着伤员的出现开始逐渐乏力(逼抢力度和节奏都有明显下降)"
"(0-0) Chelsea -0.5 @ 2.020

$50.00 Single",11/29/2020 11:18:56,50,0,-50,,2.02,,251.91,
"Chelsea @ 2.40

$50.00 Single",11/29/2020 12:44:40,50,0,-50,,2.4,,201.91,
"Chelsea @ 3.00

$50.00 Single",11/29/2020 13:01:43,50,0,-50,,3,,151.91,
"RB Leipzig @ 2.10

$100.00 Single",12/05/2020 12:57:07,100,0,-100,Bundesliga,2.1,live,51.91,"RB vs Bayern(3:3)
德甲我是从来不碰的, 这场是临场判断。拜仁比起上赛季总体是不如的, 感觉进攻很迷茫,.
RB倒是挺有特点, 反击很有针对性, 这个赛季适度看多."
"Leeds @ 6.00

$50.00 Single",12/05/2020 14:43:58,50,0,-50,,6,regular,1.91,"Chelsea vs Leeds( 3:1)
赛前判断：吉鲁周中欧冠大四喜，本场继续首发
切尔西周中多打一场，吉鲁跑动能力堪忧，怀疑会被利兹联冲死。比赛过程利兹联早早进球，但是后面显出疲态，致命弱点防空在切尔西面前暴露，切尔西直接高空轰炸砸死
利兹联在接下来的一场也是领先后被西汉姆高空球直接砸死, 进攻开始显露疲态, Koch受伤3个月，短期看空."
"Leeds to score 4th goal @ 4.50

$20.00 Single",12/05/2020 16:29:57,20,0,-20,,4.5,live goal,-18.09,"Chelsea vs Leeds
Leeds真是有点疲了"
"Club Brugge +0.5,+1.0 @ 2.030

$50.00 Single",12/07/2020 23:01:30,50,80.28,30.28,UCL,2.03,cash out,12.19,"Lazio vs Brugge (2:2)
拉齐奥2:0领先后习惯性划水(打假球), 判断准确.
Early cashout的原因是Brugge必须赢才能出线, 最后守门员都会顶出来, 为了避免意外, 提前cashout"
"Barcelona @ 2.15

$30.00 Single",12/08/2020 14:25:49,30,0,-30,UCL,2.15,,-17.81,"Barcelona vs Juventus
争议点球判罚影响了比赛结果，过程来看没有问题"
"Barcelona 0.0,-0.5 @ 1.880

$30.28 Single",12/08/2020 14:39:10,30.28,0,-30.28,UCL,1.88,,-48.09,"Barcelona vs Juventus
争议点球判罚影响了比赛结果，过程来看没有问题"
"Barcelona to score 4th goal @ 2.50

$50.00 Single",12/08/2020 16:30:34,50,0,-50,UCL,2.5,live goal,-98.09,"Barcelona vs Juventus

心态崩，live goal的风控要做好: 
<$30 + odds > 3"
"AC Milan @ 2.10
$50.00 Single",12/23/2020 12:07:31,50,105,55,Serie A,2.1,regular,-43.09,"AC milan vs Lazio
最后一分钟绝杀
难道这就是转运的开始?"
"(0-0) Chelsea -0.5 @ 1.980

$55.00 Single",12/26/2020 12:40:44,55,0,-55,PL,1.98,regular,-98.09,"Arsenal vs Chelsea
诱人的赔率，苦涩的结果
内忧外患的阿森纳(主力中卫组合伤停)赢了外强中干的切尔西, 这场有点假"
"Leeds +0.5 @ 1.875

$50.00 Single",01/01/2021 20:24:59,50,93.75,43.75,PL,1.875,Corner,-54.34,"Tottenam vs Leeds
角球大数据，突出一个稳"
"Leeds @ 4.00

$20.00 Single",01/02/2021 6:34:45,20,0,-20,PL,4,regular,-74.34,"Tottenham vs Leeds
小注搏冷, 风险控制得当"
"Leeds @ 8.50

$10.00 Single",01/02/2021 8:00:40,10,0,-10,PL,8.5,live,-84.34,"Tottenham vs Leeds
小注搏冷, 风险控制得当"
"RB Leipzig @ 2.37

$23.75 Single",01/09/2021 13:00:04,23.75,0,-23.75,,2.37,,-108.09,
"(0-1) Brighton 0.0 @ 2.300

$50.00 Single",01/16/2021 11:03:53,50,50,0,,2.3,,-108.09,
"Liverpool -0.5 @ 1.950

$40.00 Single",01/17/2021 11:29:26,40,0,-40,,1.95,,-148.09,
"Inter Milan 0.0,-0.5 @ 2.020

$100.00 Single",01/17/2021 14:45:07,100,202,102,Serie A,2.02,,-46.09,"Inter Milan 2:0 Juventus
国米三线都是意甲最强配置，硬实力第一无悬念
这场基耶利尼顶替博努奇首发， 复合更改i中卫组合原则，重注"
"Chelsea @ 2.00

$22.00 Single",01/19/2021 10:52:31,22,0,-22,,2,,-68.09,
"Leicester 0.0 @ 2.020

$30.00 Single",01/19/2021 14:39:05,30,60.6,30.6,,2.02,,-37.49,
"Atalanta 0.0,-0.5 @ 1.890

$30.60 Single",01/23/2021 11:56:00,30.6,57.84,27.24,,1.89,,-10.25,
"Lazio or Sassuolo @ 1.80

$27.84 Single",01/24/2021 13:26:48,27.84,41.76,13.92,,1.8,,3.67,
"Leeds -0.5 @ 1.940

$51.76 Single",01/26/2021 5:50:31,51.76,100.42,48.66,PL,1.94,,52.33,Newcastle v Leeds
"Leeds to score 4th goal @ 2.62

$20.00 Single",01/26/2021 14:31:02,20,0,-20,,2.62,live,32.33,自从live bet开始控制风险后收益有所改善
"Wolverhampton +0.5,+1.0 @ 2.030

$30.42 Single",01/27/2021 12:21:45,30.42,61.76,31.34,,2.03,,63.67,
"Liverpool -1.5 @ 1.750

$31.76 Single",01/28/2021 14:04:43,31.76,0,-31.76,,1.75,corner,31.91,"Liverpool3:1 Tottenham
这个角球本来是稳胆的, 结果打出角球2:1, 利物浦的角球以后要谨慎"
"Arsenal 0.0 @ 1.900

$50.00 Single",01/30/2021 10:04:05,50,0,-50,PL,1.9,corner,-18.09,"Arsenal  0:0 Man U
角球大数据也不是完全准确"
"Leeds +1.0 @ 1.850

$100.00 Single",01/31/2021 8:46:40,100,100,0,,1.85,,-18.09,
"Leeds +0.5 @ 2.070

$50.00 Single",01/31/2021 8:48:22,50,103.5,53.5,PL,2.07,,35.41,Leicester v Leeds
"Brighton @ 3.25

$23.50 Single",01/31/2021 11:39:58,23.5,76.38,52.88,,3.25,,88.29,
"Leeds to score 4th goal @ 2.62

$30.00 Single",02/03/2021 16:00:16,30,0,-30,,2.62,live,58.29,自从live bet开始控制风险后收益有所改善
"Chelsea -1.5 @ 1.900

$50.00 Single",02/04/2021 14:54:13,50,95,45,,1.9,,103.29,
"Chelsea @ 1.90

$30.00 Single",02/04/2021 15:06:58,30,57.28,27.28,,1.9,,130.57,
"Sevilla -0.5,-1.0 @ 1.950

$50.00 Single",02/06/2021 11:42:21,50,97.5,47.5,La Liga,1.95,,178.07,"Sevilla v Getafe
西甲弄的比较少。东窗戈麦斯加盟后对赛维利亚期待很高。目前来看磨合不及预期。奥坎波斯才是塞维利亚的阵眼，基本相当于2年前菲尔米诺之于利物浦"
"Everton +3.0 @ 1.800

$58.66 Single",02/06/2021 11:50:07,58.66,0,-58.66,,1.8,,119.41,
"Roma to score 2nd goal @ 3.20

$10.00 Single",02/06/2021 13:22:03,10,0,-10,,3.2,,109.41,
"Man City -0.5 @ 1.900

$57.50 Single",02/07/2021 11:25:02,57.5,0,-57.5,PL,1.9,corner,51.91,"Liverpool(1) v Man City(4)
"
"Leeds -0.5 @ 1.890

$100.00 Single",02/08/2021 14:35:30,100,189,89,,1.89,,140.91,
"Inter Milan 0.0,-0.5 @ 1.950

$30.00 Single",02/09/2021 14:43:32,30,15,-15,,1.95,,125.91,
"Liverpool -1.5 @ 1.950

$50.00 Single",02/12/2021 23:15:12,50,50,0,,1.95,,125.91,
"Leicester +0.5 @ 1.900

$24.00 Single",02/13/2021 6:53:46,24,45.6,21.6,,1.9,,147.51,
"Napoli 0.0 @ 1.775

$25.60 Single",02/13/2021 11:12:08,25.6,0,-25.6,,1.775,,121.91,
"Over 3.0 @ 2.040

$20.00 Single",02/14/2021 11:26:26,20,36.41,16.41,,2.04,,138.32,
"Under 2.5 @ 2.10

$26.41 Single",02/14/2021 14:41:39,26.41,0,-26.41,,2.1,,111.91,
"No @ 2.00

$30.00 Single",02/14/2021 14:41:59,30,0,-30,,2,,81.91,
"RB Leipzig 0.0,+0.5 @ 1.900

$30.00 Single",02/16/2021 9:47:11,30,0,-30,,1.9,,51.91,
"Under 2.5,3.0 @ 2.050

$30.00 Single",02/16/2021 9:47:30,30,61.5,31.5,,2.05,,83.41,
"PSG +0.5,+1.0 @ 1.920

$20.00 Single",02/16/2021 14:06:41,20,38.4,18.4,,1.92,,101.81,
"No 1st goal @ 6.50

$20.00 Single",02/16/2021 15:34:57,20,0,-20,,6.5,,81.81,
"Sevilla 0.0,-0.5 @ 2.040

$100.00 Single",02/16/2021 23:13:21,100,0,-100,,2.04,,-18.19,"Sevilla 2:3 Dortmund
哈兰德暴走...这个因素赛前也考虑到了. 多特蒙德哈兰德是无解的, 但是考虑到多特打拉齐奥的表现，还是信了一手塞维利亚
塞维利亚的主要问题: 没奥坎波斯打不了, 拉基蒂奇坑逼. 戈麦斯融入不够, 球权太少. 替补左后卫上不去，左路进攻基本瘫痪.
"
"Leeds +1.0 @ 1.800

$79.90 Single",02/19/2021 11:20:09,79.9,79.9,0,,1.8,,-18.19,
"Leeds +0.5 @ 2.025

$29.90 Single",02/19/2021 14:49:12,29.9,60.55,30.65,,2.025,,12.46,
"Sampdoria +1.0 @ 1.900

$20.55 Single",02/20/2021 9:01:11,20.55,20.55,0,,1.9,,12.46,
"Under 3.0 @ 2.030

$30.55 Single",02/20/2021 11:52:06,30.55,62.02,31.47,,2.03,,43.93,
"Everton +3.5 @ 2.050

$20.00 Single",02/20/2021 11:55:20,20,0,-20,,2.05,,23.93,
"Inter Milan -0.5 @ 1.990

$32.02 Single",02/20/2021 23:54:38,32.02,63.72,31.7,SerieA,1.99,,55.63,"Inter 3:0 AC milan
正常的结果，弥补一下第一回合的损失"
"Inter Milan -0.5 @ 1.850

$100.00 Single",02/21/2021 8:51:13,100,185,85,SerieA,1.85,,140.63,"Inter 3:0 AC milan
正常的结果，弥补一下第一回合的损失"
"Inter Milan to score 2nd goal @ 2.00

$30.00 Single",02/21/2021 10:11:52,30,60,30,SerieA,2,live,170.63,"Inter 3:0 AC milan
这个live在米兰起势的时候反追一手国米进球, 有点意思"
"No @ 1.95

$30.00 Single",02/21/2021 10:44:47,30,58.5,28.5,,1.95,,199.13,
"Bayern Munich -0.5,-1.0 @ 1.850

$97.22 Single",02/21/2021 13:36:30,97.22,179.86,82.64,UCL,1.85,regular,281.77,"Bayern 4: 1 Lazio
赛季翻身仗. 拜仁赛前有利空: 格纳布里，穆勒打不了, 加上拉齐奥意甲7连胜使得赔率相当划算"
"Bayern Munich -0.5,-1.0 @ 1.850

$100.00 Single",02/22/2021 8:43:18,100,185,85,,1.85,regular,366.77,"Bayern 4: 1 Lazio
赛季翻身仗. 拜仁赛前有利空: 格纳布里，穆勒打不了, 加上拉齐奥意甲7连胜使得赔率相当划算"
"Over 2.5 @ 1.66

$100.00 Single",02/23/2021 7:40:31,100,166.67,66.67,,1.66,,433.44,
"No @ 2.25

$50.00 Single",02/23/2021 23:35:33,50,112.5,62.5,,2.25,,495.94,
"Leeds -1.0 @ 1.975

$94.03 Single",02/27/2021 11:24:47,94.03,185.71,91.68,PL,1.975,corner,587.62,"Leeds 0:1 Aston villa
有点悬, 险胜"
"Leeds to score 2nd goal @ 2.00

$20.00 Single",02/27/2021 13:43:09,20,0,-20,,2,,567.62,
"Arsenal +0.5 @ 2.000

$45.71 Single",02/27/2021 20:45:22,45.71,91.42,45.71,,2,,613.33,
"Liverpool -3.0 @ 1.850

$50.00 Single",02/28/2021 8:58:43,50,0,-50,UCL,1.85,corner,563.33,"Liverpool 2:0 Sheffield
打联赛副班长, 这个角球看上去应该挺稳的。 结果最后利物浦角球还输了一个，无语...利物浦的角球以后要谨慎"
"No @ 2.05

$21.42 Single",02/28/2021 11:28:18,21.42,43.92,22.5,,2.05,,585.83,
"(0-0) Man Utd 0.0 @ 2.200

$30.00 Single",02/28/2021 11:52:51,30,30,0,,2.2,,585.83,
"Sevilla +1.0,+1.5 @ 1.825

$30.00 Single",03/03/2021 14:34:05,30,0,-30,,1.825,,555.83,
"Bayern Munich -1.0 @ 1.940

$53.92 Single",03/05/2021 23:44:37,53.92,104.61,50.69,,1.94,,606.52,
"Bayern Munich -1.0 @ 1.930

$100.00 Single",03/06/2021 6:14:39,100,193,93,Bundesliga,1.93,regular,699.52,"Bayern Munich v Borussia Dortmund(Asian Handicap)
拜仁开场先输个0:2, 随后4:2逆转
投注理由: 多特防守一般, 桑乔缺阵"
"Juventus -0.5 @ 1.960

$100.00 Single",03/06/2021 10:26:25,100,191.22,91.22,,1.96,,790.74,"Juventus v Lazio(Asian Handicap)
投注理由: 目测本赛季因莫比莱状态奇差无比"
"Bayern Munich -2.0 @ 3.450

$30.00 Single",03/06/2021 11:46:28,30,30,0,,3.45,,790.74,
"Bayern Munich @ 1.83

$50.00 Single",03/06/2021 13:56:14,50,91.67,41.67,,1.83,,832.41,
"Juventus @ 2.25

$30.00 Single",03/06/2021 15:50:16,30,65.52,35.52,,2.25,,867.93,
"No @ 1.80

$36.02 Single",03/07/2021 8:59:09,36.02,0,-36.02,La liga,1.8,btts,831.91,"Atletico Madrid v Real Madrid(Both Teams to Score)
1:1
伤不起...马竞前场抢断反击进了一个"
"RB Leipzig @ 7.00

$30.00 Single",03/07/2021 11:13:59,30,0,-30,UCL,7,,801.91,"Liverpool v RB Leipzig(To Qualify)
投注理由: 利物浦英超主场5连败, 有崩盘的迹象
7倍赔率值的投机"
"RB Leipzig @ 3.00

$30.00 Single",03/07/2021 11:17:42,30,0,-30,UCL,3,regular,771.91,"Liverpool v RB Leipzig 2:0
投机一下.
比赛过程很出乎意料, 莱比锡没有Angeliho真的
打不了."
"Man Utd -0.5,-1.0 @ 1.900

$50.00 Single",03/07/2021 12:21:18,50,0,-50,UCL,1.9,,721.91,"Man Utd v AC Milan(Asian Handicap) 1:1
阵容残缺的米兰补时绝平, 曼联也算是大热死吧..."
"Leeds to score 3rd goal @ 2.40

$20.00 Single",03/08/2021 16:16:07,20,0,-20,,2.4,,701.91,
"Sevilla 0.0,+0.5 @ 2.000

$50.00 Single",03/09/2021 14:04:28,50,75,25,,2,,726.91,
"Sevilla -0.5 @ 1.875

$50.00 Single",03/09/2021 14:36:10,50,93.75,43.75,,1.875,,770.66,
"Sevilla -1.5 @ 6.800

$20.00 Single",03/09/2021 14:38:08,20,0,-20,,6.8,,750.66,
"RB Leipzig @ 4.00

$28.75 Single",03/10/2021 16:19:15,28.75,0,-28.75,,4,,721.91,
"Shakhtar Donetsk +1.0 @ 1.850

$20.00 Single",03/10/2021 22:54:59,20,0,-20,,1.85,,701.91,
"No @ 2.05

$20.00 Single",03/10/2021 23:06:01,20,41,21,UCL,2.05,btts,722.91,Roma v Shakhtar Donetsk(Both Teams to Score)
"No @ 1.95

$20.00 Single",03/10/2021 23:06:52,20,0,-20,UCL,1.95,btts,702.91,"Man Utd v AC Milan(Both Teams to Score)
很久不玩BTTS了, AC米兰93分钟进了一个，伤不起
杯赛淘汰赛赔率合适的话还是可以玩玩btts"
"Leeds @ 4.80

$21.00 Single",03/13/2021 6:40:32,21,0,-21,,4.8,,681.91,
"Leeds +0.5,+1.0 @ 1.990

$50.00 Single",03/13/2021 6:40:41,50,99.5,49.5,PL,1.99,regular,731.41,"Leeds v Chelsea(Asian Handicap) 0: 0
投注理由: 切尔西接下来周中欧冠生死战
首发阵容明显留力"
"Leeds +1.5 @ 1.825

$80.00 Single",03/13/2021 6:41:15,80,146,66,PL,1.825,corner,797.41,Leeds v Chelsea(Asian Handicap Corners)
"Leeds @ 5.25

$20.00 Single",03/13/2021 7:28:52,20,0,-20,,5.25,,777.41,
"Leeds or Draw @ 1.90

$30.00 Single",03/13/2021 8:05:57,30,57.28,27.28,,1.9,live,804.69,"Leeds v Chelsea(Asian Handicap)
滚球"
"Over 1.5,2.0 @ 1.810

$30.00 Single",03/13/2021 14:45:43,30,0,-30,,1.81,,774.69,
"Over 1.5,2.0 @ 1.810

$22.78 Single",03/13/2021 14:55:36,22.78,0,-22.78,,1.81,,751.91,
"Arsenal -1.0 @ 1.850

$50.00 Single",03/14/2021 10:43:21,50,92.5,42.5,PL,1.85,corner,794.41,"Arsenal v Tottenham(2: 1)
打热刺这个角球还是很稳的"
"Arsenal 0.0 @ 1.940

$50.00 Single",03/14/2021 11:27:34,50,97,47,PL,1.94,regular,841.41,Arsenal v Tottenham(2: 1)
"Arsenal @ 2.60

$20.00 Single",03/14/2021 12:43:43,20,52,32,,2.6,live,873.41,"Arsenal v Tottenham(2: 1)
最近滚球还有点顺，风险控制也合适i"
"Liverpool -1.5 @ 1.800

$51.50 Single",03/15/2021 14:13:37,51.5,0,-51.5,PL,1.8,corner,821.91,"Wolverhampton v Liverpool(Asian Handicap Corners)
利物浦角球的variance比较大
以后投注角球要好好考虑variance和赔率是否划算
这场角球数利物浦2:3输给狼队"
"Real Madrid 0.0 @ 2.000

$50.00 Single",03/16/2021 14:32:36,50,0,-50,UCL,2,corner,771.91,"Real Madrid v Atalanta(Corner)
赢球输角，常规操作"
"(0-0) Real Madrid 0.0,-0.5 @ 2.100

$70.00 Single",03/16/2021 15:12:07,70,147,77,UCL,2.1,,848.91,"Real Madrid v Atalanta(Asian Handicap)
亚特兰大东窗走核心戈麦斯, 偏向于看空
实际比赛过程皇马赢得很轻松"
"Chelsea 0.0,-0.5 @ 1.990

$27.00 Single",03/16/2021 16:55:47,27,27,0,,1.99,,848.91,
"Chelsea -0.5 @ 1.900

$20.00 Single",03/17/2021 11:17:38,20,20,0,,1.9,,848.91,
"Chelsea 0.0,-0.5 @ 2.020

$20.00 Single",03/17/2021 14:45:08,20,20,0,,2.02,,848.91,
"Atletico Madrid to score 2nd goal @ 3.60

$27.00 Single",03/17/2021 16:17:17,27,0,-27,,3.6,,821.91,
"Atletico Madrid to score 2nd goal @ 4.00

$20.00 Single",03/17/2021 16:19:59,20,0,-20,,4,,801.91,
"Man Utd -0.5 @ 2.000

$100.00 Single",03/18/2021 11:22:38,100,100,0,UCL,2,,801.91,"AC Milan v Man Utd (0:1)
首回合1:1, 次回合曼联取胜才能晋级
曼联很热, 米兰很多主力缺阵,
但是欧联杯还是要控制风险为主, 
这一单我cash out了"
"Man Utd 0.0 @ 1.800

$50.00 Single",03/18/2021 11:22:49,50,50,0,,1.8,,801.91,
"Man Utd -0.5 @ 1.975

$30.00 Single",03/18/2021 11:47:13,30,59.25,29.25,UCL,1.975,,831.16,"AC Milan v Man Utd (0:1)
首回合1:1, 次回合曼联取胜才能晋级"
"Leeds 0.0 @ 2.050

$59.25 Single",03/18/2021 16:56:53,59.25,121.47,62.22,PL,2.05,regular,893.38,"Fulham v Leeds(1:2)
fulham要保级, 利兹联排名无欲无求. 赛前赔率
看好fulham"
"Leeds 0.0 @ 1.800

$20.00 Single",03/19/2021 9:13:06,20,0,-20,PL,1.8,corner,873.38,"Fulham v Leeds(1:2)
角球，风险控制得当, 合理对冲胜负盘"
"Leeds 0.0 @ 2.070

$30.00 Single",03/19/2021 14:58:48,30,62.1,32.1,,2.07,,905.48,
"Leeds @ 2.60

$30.00 Single",03/19/2021 15:22:12,30,78,48,,2.6,,953.48,
"Arsenal -0.5 @ 1.900

$51.57 Single",03/20/2021 22:37:22,51.57,97.99,46.42,,1.9,,999.9,
"Arsenal -0.5 @ 1.900

$30.00 Single",03/21/2021 9:57:28,30,57,27,,1.9,,1026.9,
"Aston Villa 0.0,+0.5 @ 2.020

$24.99 Single",03/21/2021 12:02:14,24.99,0,-24.99,,2.02,,1001.91,
"Aston Villa @ 3.00

$20.00 Single",03/21/2021 14:39:22,20,0,-20,,3,,981.91,
"Sevilla 0.0 @ 2.020

$50.00 Single",04/02/2021 17:57:22,50,101,51,La liga,2.02,,1032.91,Sevilla v Atletico Madrid(Asian Handicap)
"Leeds -1.0 @ 1.940

$30.00 Single",04/02/2021 17:57:52,30,30,0,PL,1.94,,1032.91,
"Leeds to score 4th goal @ 1.95

$20.00 Single",04/03/2021 10:30:21,20,0,-20,PL,1.95,,1012.91,
"Bayern Munich 0.0 @ 1.960

$110.00 Single",04/03/2021 11:26:51,110,215.6,105.6,Bundesliga,1.96,,1118.51,RB Leipzig v Bayern Munich(Asian Handicap)
"Liverpool @ 2.62

$20.00 Single",04/03/2021 15:19:52,20,52.5,32.5,,2.62,,1151.01,
"Real Madrid 0.0 @ 1.950

$48.10 Single",04/03/2021 20:53:25,48.1,44.46,-3.64,UCL,1.95,cash out,1147.37,
"Liverpool 0.0,-0.5 @ 2.100

$25.46 Single",04/06/2021 11:52:07,25.46,23.25,-2.21,UCL,2.1,cash out,1145.16,
"Man City -1.5 @ 2.010

$20.00 Single
($20.00 Bet Credits)",04/06/2021 11:56:32,20,20,0,,2.01,,1145.16,
"Liverpool 0.0 @ 2.020

$20.00 Single",04/06/2021 13:55:56,20,0,-20,UCL,2.02,,1125.16,"Real Madrid 3: 1 Liverpool
https://www.notion.so/match-notes-938aa441680746cda6913d06e8d9ced0"
"Liverpool 0.0 @ 2.020

$23.25 Single",04/06/2021 13:56:37,23.25,0,-23.25,UCL,2.02,,1101.91,"Real Madrid 3: 1 Liverpool
https://www.notion.so/match-notes-938aa441680746cda6913d06e8d9ced0"
"PSG +0.5 @ 1.880

$50.00 Single",04/07/2021 13:51:16,50,94,44,UCL,1.88,,1145.91,
"PSG to score 2nd goal @ 2.40

$20.00 Single",04/07/2021 14:08:01,20,48,28,UCL,2.4,live,1173.91,
"PSG @ 2.10

$20.00 Single",04/07/2021 14:15:55,20,42,22,UCL,2.1,,1195.91,
"PSG to score 6th goal @ 3.75

$20.00 Single",04/07/2021 15:31:31,20,0,-20,UCL,3.75,live,1175.91,
"Leeds +1.5 @ 2.050

$34.00 Single",04/07/2021 21:19:03,34,69.7,35.7,PL,2.05,regular,1211.61,"Leeds 2:1 Man City
利兹联队下半场少打一人，最后时刻逆转
投注依据: 曼城周中欧冠生死战, 这场必须轮换+大保健踢法
瓜迪奥拉在联赛无压力的强况下也有可能要卖贝尔萨一个人情
"
"Barcelona 0.0,-0.5 @ 2.060

$40.00 Single",04/09/2021 11:10:11,40,0,-40,,2.06,,1171.61,
"Union Berlin +0.5,+1.0 @ 1.930

$40.00 Single",04/10/2021 7:42:54,40,77.2,37.2,Bundesliga,1.93,regular,1208.81,"Bayern 1:1 Union Berlin
最近拜仁比较关注, 比赛也搞得比较多
拜仁的问题就是双线疲惫, 伤病压力太大(莱万, 格纳布里). 所以赌一手双线崩盘"
"Union Berlin @ 4.50

$30.00 Single",04/10/2021 7:51:46,30,30,0,Bundesliga,4.5,cash out,1208.81,
"No @ 2.62

$30.00 Single",04/10/2021 13:59:49,30,0,-30,La liga,2.62,btts,1178.81,"Real Madrid 2:1 Barcelona(Both Teams to Score)
基本面方面皇马周中欧冠苦战, 主力后卫瓦拉内缺阵. 这是一场决定冠军归属的关键战 (第二vs第一)
巴萨专注联赛，多休息3天"
"Barcelona @ 4.00

$30.00 Single",04/10/2021 14:19:39,30,0,-30,La liga,4,,1148.81,"Real Madrid 2:1 Barcelona
滚一下球"
"Barcelona @ 8.00

$20.00 Single",04/10/2021 15:18:03,20,0,-20,La liga,8,,1128.81,Real Madrid 2:1 Barcelona
"Man Utd -0.5 @ 1.875

$126.90 Single",04/11/2021 10:21:37,126.9,0,-126.9,,1.875,,1001.91,
"Man Utd 0.0,-0.5 @ 2.100

$20.00 Single",04/11/2021 10:29:43,20,42,22,PL,2.1,corner,1023.91,"Tottenham v Man Utd(Asian Handicap Corners)
曼联3: 1赢球, 但是角球没打出来.
曼联的角球属于高均值低variance, 本场卡瓦尼首发，曼联战意拉满, 投注理由充分"
"FC Porto +0.5 @ 2.080

$22.00 Single",04/13/2021 13:07:46,22,45.76,23.76,UCL,2.08,,1047.67,
"PSG 0.0,+0.5 @ 1.950

$50.00 Single",04/13/2021 13:10:48,50,0,-50,UCL,1.95,,997.67,Paris 0:1 Bayern 
"PSG 0.0,+0.5 @ 1.950

$50.00 Single",04/13/2021 13:10:56,50,0,-50,UCL,1.95,,947.67,Paris 0:1 Bayern 
"FC Porto @ 4.60

$50.00 Single",04/13/2021 13:23:24,50,230,180,UCL,4.6,regular,1127.67,"Porto 1: 0 Chelsea
合理博冷. 切尔西这个队挺狗的, 第二回合在确保出线的情况下狗着踢"
"FC Porto to score 1st goal @ 5.50

$50.00 Single",04/13/2021 15:30:45,50,275,225,UCL,5.5,live,1352.67,"Porto 1: 0 Chelsea
合理博冷. 切尔西这个队挺狗的, 第二回合在确保出线的情况下狗着踢"
"Man City -1.0 @ 2.080

$50.76 Single",04/13/2021 16:43:31,50.76,50.76,0,UCL,2.08,,1352.67,"Man City 2:1 Dortmund
欧冠第二回合, 投注理由: 多特蒙德打拉齐奥都他妈费力...
哈兰德大概率走人, 多特这种年年卖人赚钱的队真心不看好, 球员踢球都是为了卖个好价钱
瓜迪奥拉现在是越来越经济实惠了, 能赢一球绝不赢两球"
"Man City -1.0 @ 2.080

$50.00 Single",04/13/2021 21:31:22,50,50,0,UCL,2.08,,1352.67,
"Liverpool -0.5 @ 1.980

$50.00 Single",04/14/2021 4:41:56,50,0,-50,UCL,1.98,,1302.67,"Liverpool 0:0 Real Madrid
次回合利物浦需要2:0才能晋级"
"Liverpool @ 2.75

$20.00 Single",04/14/2021 15:28:34,20,0,-20,UCL,2.75,live,1282.67,
"Arsenal -0.5,-1.0 @ 2.020

$80.76 Single",04/15/2021 13:24:09,80.76,163.14,82.38,UCL,2.02,,1365.05,"Arsenal 4: 0 xxxx
欧联杯, 投注依据: arsenal 虐菜指数挺高, 打弱队经常能形成压制优势
萨卡付出，坑逼奥巴梅扬没上"
"Wolfsburg +0.5 @ 1.990

$33.14 Single",04/17/2021 8:09:05,33.14,0,-33.14,Bundesliga,1.99,regular,1331.91,"Bayern 1:0 Wolfsburg
最近拜仁比较关注, 比赛也搞得比较多
拜仁的问题就是双线疲惫, 伤病压力太大(莱万, 格纳布里). 所以赌一手双线崩盘"
"Man City -1.5 @ 1.850

$30.00 Single",04/17/2021 11:30:44,30,55.5,25.5,PL,1.85,corner,1357.41,"Chelsea 1: 0 Man City
足总杯半决赛, 双方都是划水. 完全没上强度"
"Draw @ 4.50

$35.50 Single",04/18/2021 22:52:07,35.5,159.75,124.25,PL,4.5,Regular,1481.66,"Leeds 1:1 Liverpool
打到这个阶段, 利兹联的比赛拿捏的死死的
独平都能压中..."
"Leeds +2.0 @ 1.800

$50.00 Single",04/18/2021 22:52:31,50,90,40,PL,1.8,corner,1521.66,
"Shandong Taishan -1.0 @ 1.875

$39.75 Single",04/20/2021 6:09:14,39.75,74.54,34.79,CSL,1.875,regular,1556.45,"山东2:0 xxx
今年CSL开门红"
"(0-0) Brighton +0.5 @ 2.075

$34.54 Single",04/20/2021 14:29:18,34.54,71.68,37.14,,2.075,,1593.59,
"Over 2.5,3.0 @ 1.970

$51.68 Single",04/21/2021 3:41:01,51.68,76.75,25.07,PL,1.97,goal,1618.66,"Tottenham 2:1 Southampton
投注理由: 热刺换帅,  肯定不会再狗了...
南安普顿也是高位压迫开放型打法, 直接去大球"
"Over 2.5,3.0 @ 2.010

$40.00 Single",04/21/2021 11:18:29,40,60.2,20.2,PL,2.01,goal,1638.86,"Tottenham 2:1 Southampton
投注理由: 热刺换帅,  肯定不会再狗了...
南安普顿也是高位压迫开放型打法, 直接去大球"
"Over 2.5 @ 2.00

$50.00 Single",04/21/2021 12:13:07,50,100,50,PL,2,goal,1688.86,"Tottenham 2:1 Southampton
投注理由: 热刺换帅,  肯定不会再狗了...
南安普顿也是高位压迫开放型打法, 直接去大球"
"Getafe -1.0 @ 2.050

$36.95 Single",04/21/2021 19:07:57,36.95,36.95,0,La liga,2.05,cash out,1688.86,"Getafe vs Barcelona
联赛得牌最多的队对得牌最少的队，结果巴塞黄牌还多点...
结论: card千万别碰"
"Shanghai Shenhua @ 3.40

$36.95 Single",04/23/2021 7:47:18,36.95,125.63,88.68,CSL,3.4,live,1777.54,"申花2:1 国安
实盘追入, 申花实力明显占优, 战术和组织都高一档"
"Shanghai Shenhua @ 3.50

$50.00 Single",04/23/2021 8:10:03,50,175,125,CSL,3.5,live,1902.54,"申花2:1 国安
实盘追入, 申花实力明显占优, 战术和组织都高一档"
"Shanghai Shenhua @ 1.95

$50.63 Single",04/23/2021 9:49:29,50.63,98.73,48.1,CSL,1.95,live,1950.64,"申花2:1 国安
实盘追入, 申花实力明显占优, 战术和组织都高一档"
"Everton +0.5 @ 1.890

$50.00 Single",04/23/2021 11:58:59,50,94.5,44.5,PL,1.89,regular,1995.14,"Everton 1: 0 Arsenal
投注依据: 拉卡泽特缺阵
阿森纳进攻的阵眼"
"Draw @ 6.00

$24.50 Single",04/24/2021 13:03:45,24.5,0,-24.5,PL,6,live,1970.64,West Ham v Chelsea
"Over 2.5,3.0 @ 1.910

$70.00 Single",04/25/2021 10:20:40,70,0,-70,PL,1.91,goal,1900.64,"Man City 1:0 Tottenham
联赛杯决赛, 热刺换帅，以为不会狗了，会对攻. 结果还是曼城狗
"
"AC Milan 0.0,+0.5 @ 2.000

$100.00 Single",04/26/2021 11:14:18,100,0,-100,Serie A,2,regular,1800.64,"Lazio 3: 0 AC Milan
没啥好说的... 意甲这赛季就是坑"
"AC Milan @ 3.10

$50.00 Single",04/26/2021 11:14:34,50,50,0,Serie A,3.1,,1800.64,"Lazio 3: 0 AC Milan
没啥好说的... 意甲这赛季就是坑"
"AC Milan or Draw @ 2.62

$50.00 Single",04/26/2021 14:07:52,50,0,-50,Serie A,2.62,live,1750.64,"Lazio 3: 0 AC Milan
没啥好说的... 意甲这赛季就是坑"
"Chelsea 0.0,+0.5 @ 1.820

$50.00 Single",04/27/2021 13:07:41,50,70.5,20.5,UCL,1.82,regular,1771.14,"Chelsea 1: 1 Real Madrid
这场开场发现皇马马塞洛明显弱点，皇马完全懵圈,
实盘持续追入切尔西.
比赛走势符合判断, 切尔西场面占优且在20分钟左右取得领先
可惜后面皇马缓过气来，没能拿下"
"Chelsea 0.0,+0.5 @ 1.820

$100.00 Single",04/27/2021 13:09:08,100,141,41,UCL,1.82,regular,1812.14,"Chelsea 1: 1 Real Madrid
这场开场发现皇马马塞洛明显弱点，皇马完全懵圈,
实盘持续追入切尔西.
比赛走势符合判断, 切尔西场面占优且在20分钟左右取得领先
可惜后面皇马缓过气来，没能拿下"
"(0-0) Chelsea 0.0 @ 2.060

$100.00 Single",04/27/2021 14:06:31,100,100,0,UCL,2.06,,1812.14,"Chelsea 1: 1 Real Madrid
这场开场发现皇马马塞洛明显弱点，皇马完全懵圈,
实盘持续追入切尔西.
比赛走势符合判断, 切尔西场面占优且在20分钟左右取得领先
可惜后面皇马缓过气来，没能拿下"
"(0-0) Chelsea 0.0 @ 1.890

$100.00 Single",04/27/2021 14:11:36,100,100,0,UCL,1.89,,1812.14,"Chelsea 1: 1 Real Madrid
这场开场发现皇马马塞洛明显弱点，皇马完全懵圈,
实盘持续追入切尔西.
比赛走势符合判断, 切尔西场面占优且在20分钟左右取得领先
可惜后面皇马缓过气来，没能拿下"
"Chelsea to score 2nd goal @ 2.10

$20.00 Single",04/27/2021 14:25:14,20,0,-20,UCL,2.1,live,1792.14,"Chelsea 1: 1 Real Madrid
这场开场发现皇马马塞洛明显弱点，皇马完全懵圈,
实盘持续追入切尔西.
比赛走势符合判断, 切尔西场面占优且在20分钟左右取得领先
可惜后面皇马缓过气来，没能拿下"
"(0-1) Chelsea 0.0 @ 1.850

$100.00 Single",04/27/2021 14:26:22,100,0,-100,UCL,1.85,live,1692.14,"Chelsea 1: 1 Real Madrid
这场开场发现皇马马塞洛明显弱点，皇马完全懵圈,
实盘持续追入切尔西.
比赛走势符合判断, 切尔西场面占优且在20分钟左右取得领先
可惜后面皇马缓过气来，没能拿下"
"(1-1) Chelsea -0.5 @ 2.675

$80.00 Single",04/27/2021 14:39:50,80,0,-80,UCL,2.675,live,1612.14,"Chelsea 1: 1 Real Madrid
这场开场发现皇马马塞洛明显弱点，皇马完全懵圈,
实盘持续追入切尔西.
比赛走势符合判断, 切尔西场面占优且在20分钟左右取得领先
可惜后面皇马缓过气来，没能拿下"
"(1-1) Chelsea 0.0 @ 1.675

$100.00 Single",04/27/2021 15:22:40,100,100,0,UCL,1.675,,1612.14,
"Chelsea @ 3.60

$50.00 Single",04/27/2021 15:23:37,50,0,-50,UCL,3.6,,1562.14,
"No @ 2.10

$61.50 Single",04/27/2021 22:38:21,61.5,0,-61.5,UCL,2.1,,1500.64,"Man CIty 2:1 Paris SG
Match Notes:
https://www.notion.so/match-notes-938aa441680746cda6913d06e8d9ced0#1c359b6bf3264585a41a74e11df57fc0"
"Shanghai Haigang -0.5,-1.0 @ 1.925

$50.00 Single",04/28/2021 4:46:51,50,96.25,46.25,CSL,1.925,regular,1546.89,"上海申花 3:1 湖北
申花第一场看了, 明显是中超独一档的存在.
这场先丢一球随后逆转
重点关注"
"Man City -0.5 @ 2.080

$46.25 Single",04/28/2021 7:26:38,46.25,96.2,49.95,UCL,2.08,,1596.84,"Man CIty 2:1 Paris SG
Match Notes:
https://www.notion.so/match-notes-938aa441680746cda6913d06e8d9ced0#1c359b6bf3264585a41a74e11df57fc0"
"Shanghai Shenhua @ 9.50

$36.20 Single",04/29/2021 5:18:35,36.2,0,-36.2,CSL,9.5,live,1560.64,"上海申花 3:1 湖北
申花第一场看了, 明显是中超独一档的存在.
这一注属于操作失误"
"Shanghai Shenhua to score 4th goal @ 3.10

$60.00 Single",04/29/2021 6:33:11,60,186,126,CSL,3.1,live,1686.64,"上海申花 3:1 湖北
申花第一场看了, 明显是中超独一档的存在.
这场先丢一球随后逆转
重点关注"
"Brighton @ 2.00

$64.73 Single",05/01/2021 8:43:38,64.73,64.73,0,,2,cash out,1686.64,"Brighton 2: 0 Leeds
利兹联的比赛拿捏的死死的. 赛前首发没有菲利普斯和拉菲尼亚基本确定白给, 重注收米"
"Brighton -0.5 @ 2.110

$60.00 Single",05/01/2021 8:43:50,60,126.6,66.6,PL,2.11,regular,1753.24,"Brighton 2: 0 Leeds
利兹联的比赛拿捏的死死的. 赛前首发没有菲利普斯和拉菲尼亚基本确定白给, 重注收米"
"Brighton -0.5 @ 2.110

$84.73 Single",05/01/2021 8:44:15,84.73,178.79,94.06,PL,2.11,regular,1847.3,"Brighton 2: 0 Leeds
利兹联的比赛拿捏的死死的. 赛前首发没有菲利普斯和拉菲尼亚基本确定白给, 重注收米"
"Brighton -0.5 @ 2.100

$40.00 Single",05/01/2021 8:50:29,40,84,44,PL,2.1,regular,1891.3,"Brighton 2: 0 Leeds
利兹联的比赛拿捏的死死的. 赛前首发没有菲利普斯和拉菲尼亚基本确定白给, 重注收米"
"Over 2.5 @ 2.20

$39.39 Single",05/01/2021 12:36:05,39.39,0,-39.39,PL,2.2,"live
goal",1851.91,Chelsea 2:0 Fulham
"Over 2.5,3.0 @ 1.930

$50.00 Single",05/02/2021 11:02:09,50,96.5,46.5,,1.93,,1898.41,
"Chelsea 0.0,-0.5 @ 1.920

$96.50 Single",05/03/2021 7:16:27,96.5,91.68,-4.82,,1.92,,1893.59,
"(0-0) Sevilla -1.0 @ 2.200

$50.00 Single",05/03/2021 14:22:53,50,0,-50,,2.2,,1843.59,
"(0-0) Sevilla -0.5 @ 1.990

$50.00 Single",05/03/2021 15:05:37,50,0,-50,,1.99,,1793.59,
"Sevilla @ 3.00

$50.00 Single",05/03/2021 15:33:04,50,0,-50,,3,,1743.59,
"Over 2.5 @ 2.37

$50.00 Single",05/04/2021 15:24:18,50,0,-50,,2.37,,1693.59,
"Real Madrid 0.0 @ 2.000

$100.00 Single",05/04/2021 22:18:18,100,200,100,UCL,2,corner,1793.59,"Chelsea v Real Madrid(Asian Handicap Corners)
欧冠次回合, 皇马需要赢， 这个角球盘很便宜"
"Shanghai Shenhua @ 5.00

$50.00 Single",05/05/2021 8:15:01,50,0,-50,,5,,1743.59,
"(0-0) Shanghai Shenhua 0.0 @ 2.750

$100.00 Single",05/05/2021 8:16:32,100,100,0,,2.75,,1743.59,
"(0-0) Shanghai Shenhua 0.0 @ 2.750

$50.00 Single",05/05/2021 8:16:49,50,50,0,,2.75,,1743.59,
"(0-0) Over 1.0 @ 2.350

$100.00 Single",05/05/2021 8:19:31,100,235,135,CSL,2.35,live,1878.59,"Shanghai Shenhua v Shanghai Haigang (1:1)
上海申花换人调整符合预期, 下半场后半段实盘追入。结果上海申花补时扳平"
"Shanghai Shenhua @ 41.00

$10.00 Single",05/05/2021 8:37:34,10,0,-10,,41,,1868.59,
"Chelsea 0.0,-0.5 @ 1.940

$75.00 Single",05/05/2021 9:26:21,75,145.5,70.5,UCL,1.94,regular,1939.09,"Chelsea v Real Madrid(Asian Handicap)
这个赛季重点关注的切尔西, 防守稳健, 反击能力非常强. 皇马走到半决赛已经是到了极限, 阿扎尔首发基本确定走远"
"No @ 1.95

$100.00 Single",05/05/2021 13:11:25,100,195,95,UCL,1.95,BTTS,2034.09,"Chelsea v Real Madrid(Asian Handicap)
这个赛季重点关注的切尔西, 防守稳健, 反击能力非常强. 皇马走到半决赛已经是到了极限, 阿扎尔首发基本确定走远"
"(1-0) Chelsea 0.0 @ 1.525

$91.68 Single",05/05/2021 15:14:21,91.68,139.82,48.14,UCL,1.525,live,2082.23,Chelsea v Real Madrid(Alternative Asian Handicap)
"Chelsea +0.5 @ 1.970

$30.32 Single",05/05/2021 20:42:20,30.32,30.32,0,,1.97,,2082.23,
"(0-0) Villarreal 0.0 @ 2.750

$50.00 Single",05/06/2021 14:15:21,50,50,0,,2.75,,2082.23,
"(0-0) Villarreal +0.5 @ 1.950

$50.00 Single",05/06/2021 14:16:08,50,56.02,6.02,,1.95,,2088.25,
"(0-0) Over 0.5 @ 2.070

$36.02 Single",05/06/2021 15:39:06,36.02,0,-36.02,,2.07,,2052.23,
"Over 2.5,3.0 @ 1.890

$50.32 Single",05/08/2021 6:04:22,50.32,95.11,44.79,EPL,1.89,goal,2097.02,"Leeds v Tottenham(3:1)
托特纳姆换帅后打得比较开放, 大球符合预期.
从进球时间分布来看, Leeds下半场后劲十足, 贝尔萨临场调整能力很强, 追入收米"
"(2-1) Leeds 0.0 @ 2.300

$30.00 Single",05/08/2021 7:56:30,30,69,39,EPL,2.3,live,2136.02,"Leeds v Tottenham(3:1)
托特纳姆换帅后打得比较开放, 大球符合预期.
从进球时间分布来看, Leeds下半场后劲十足, 贝尔萨临场调整能力很强, 追入收米"
"No @ 2.00

$54.10 Single",05/08/2021 8:54:13,54.1,108.2,54.1,La liga,2,BTTS,2190.12,"Barcelona v Atletico Madrid(0:0)
西甲争冠生死战"
"Over 0.5 @ 1.61

$30.01 Single",05/08/2021 10:42:06,30.01,0,-30.01,,1.61,,2160.11,
"Over 0.5 @ 1.90

$20.00 Single",05/08/2021 10:51:12,20,0,-20,,1.9,,2140.11,
"Chelsea +0.5 @ 1.860

$138.20 Single",05/08/2021 11:26:11,138.2,257.06,118.86,EPL,1.86,regular,2258.97,"Man City v Chelsea(1:2)
欧冠决赛的预演. 瓜迪奥拉替补出战, 打得主意是赢了白得一个心理优势, 输了也可以实验战术, 在欧冠决赛打针对"
"Chelsea @ 4.00

$50.00 Single",05/08/2021 11:45:18,50,200,150,EPL,4,regular,2408.97,"Man City v Chelsea(1:2)
欧冠决赛的预演. 瓜迪奥拉替补出战, 打得主意是赢了白得一个心理优势, 输了也可以实验战术, 在欧冠决赛打针对"
"Sevilla +0.5 @ 1.970

$57.06 Single",05/08/2021 16:45:07,57.06,54.21,-2.85,,1.97,,2406.12,
"Sevilla +0.5 @ 1.970

$50.00 Single",05/08/2021 22:40:50,50,98.5,48.5,,1.97,,2454.62,
"No @ 2.10

$30.00 Single",05/09/2021 11:43:38,30,0,-30,La liga,2.1,BTTS,2424.62,"Real Madrid 2:2 Sevilla
塞维利亚感觉有点提前放弃, 踢的有点假. 这个队和莱比锡红牛一样属于我准备拉黑的队
皇马补时绝平. "
"Under 2.5 @ 2.10

$30.00 Single",05/09/2021 11:43:47,30,0,-30,La liga,2.1,goal,2394.62,"Real Madrid 2:2 Sevilla
塞维利亚感觉有点提前放弃, 踢的有点假. 这个队和莱比锡红牛一样属于我准备拉黑的队
皇马补时绝平. "
"Real Madrid to score 4th goal @ 2.75

$34.21 Single",05/09/2021 15:34:35,34.21,94.08,59.87,,2.75,live,2454.49,"Real Madrid 2:2 Sevilla
塞维利亚感觉有点提前放弃, 踢的有点假. 这个队和莱比锡红牛一样属于我准备拉黑的队
皇马补时绝平. "
"Real Madrid to score 4th goal @ 3.20

$30.00 Single",05/09/2021 15:38:13,30,96,66,,3.2,live,2520.49,"Real Madrid 2:2 Sevilla
塞维利亚感觉有点提前放弃, 踢的有点假. 这个队和莱比锡红牛一样属于我准备拉黑的队
皇马补时绝平. "
"Shanghai Shenhua -0.5 @ 1.925

$58.58 Single",05/10/2021 4:56:41,58.58,0,-58.58,CSL,1.925,,2461.91,"Hebei v Shanghai Shenhua(1:1)
申花和赛季初的表现开始有所出入了"
"Shanghai Shenhua @ 3.75

$30.00 Single",05/10/2021 6:06:26,30,0,-30,CSL,3.75,,2431.91,"Hebei v Shanghai Shenhua(1:1)
申花和赛季初的表现开始有所出入了"
"Leicester +0.5 @ 1.850

$130.00 Single",05/11/2021 9:09:22,130,130,0,,1.85,,2431.91,
"Leicester @ 2.10

$50.00 Single",05/11/2021 11:02:05,50,85.91,35.91,EPL,2.1,early cashout,2467.82,"Man Utd v Leicester
曼联有欧联任务, 这场全替补放了"
"Leicester +0.5 @ 1.850

$100.00 Single",05/11/2021 11:02:25,100,185,85,EPL,1.85,regular,2552.82,"Man Utd v Leicester
曼联有欧联任务, 这场全替补放了"
"Liverpool 0.0 @ 1.810

$80.91 Single",05/11/2021 15:52:22,80.91,146.45,65.54,EPL,1.81,regular,2618.36,"Man Utd v Liverpool(2:4)
曼联有欧联任务, 利物浦心无旁骛
马奎尔不能踢"
"Liverpool 0.0,-0.5 @ 2.125

$70.00 Single",05/12/2021 21:25:59,70,148.75,78.75,EPL,2.125,regular,2697.11,"Man Utd v Liverpool(2:4)
曼联有欧联任务, 利物浦心无旁骛
马奎尔不能踢"
"Over 3.0 @ 2.070

$65.20 Single",05/15/2021 5:56:42,65.2,134.97,69.77,,2.07,,2766.88,
"Yes @ 1.90

$30.00 Single",05/15/2021 7:38:42,30,0,-30,,1.9,,2736.88,
"Chelsea -0.5 @ 2.050

$64.97 Single",05/15/2021 9:09:22,64.97,0,-64.97,,2.05,,2671.91,
"Inter Milan @ 3.30

$50.00 Single",05/15/2021 10:10:04,50,0,-50,,3.3,,2621.91,
"(0-0) Liverpool -2.0 @ 2.075

$70.00 Single",05/16/2021 10:39:51,70,0,-70,EPL,2.075,live,2551.91,经典时刻：Liverpool 补时阿利松绝杀降级队
"Shanghai Shenhua 0.0,-0.5 @ 1.925

$150.00 Single",05/17/2021 6:27:39,150,0,-150,CSL,1.925,,2401.91,"国家队集训，国脚提前离队.
但是输球任然是比较意外...开始坑爹了"
"(0-0) Shanghai Shenhua -0.5 @ 2.850

$100.00 Single",05/17/2021 8:14:30,100,0,-100,CSL,2.85,,2301.91,
"(0-0) Shanghai Shenhua 0.0,-0.5 @ 2.300

$100.00 Single",05/17/2021 8:14:42,100,0,-100,CSL,2.3,,2201.91,
"Chelsea -0.5,-1.0 @ 1.940

$100.00 Single",05/17/2021 22:28:31,100,147,47,,1.94,,2248.91,
"Leeds 0.0 @ 1.975

$100.00 Single",05/17/2021 22:29:07,100,100,0,,1.975,,2248.91,
"Over 3.0 @ 1.830

$100.00 Single",05/18/2021 7:19:12,100,0,-100,EPL,1.83,goal,2148.91,"Southampton v Leeds(0:2)
无欲无求的两队，没打出大球颇为意外"
"Over 3.0 @ 1.960

$100.00 Single",05/18/2021 11:18:38,100,0,-100,EPL,1.96,goal,2048.91,"Southampton v Leeds(0:2)
无欲无求的两队，没打出大球颇为意外"
"Chelsea -0.5,-1.0 @ 1.980

$100.00 Single",05/18/2021 13:34:53,100,149,49,,1.98,,2097.91,"Chelsea v Leicester(2:1)
欧冠资格生死战, 切尔西技高一筹, 拿捏的死死的
莱斯特主要的问题是瓦尔迪状态下滑, 阵眼巴恩斯长期伤缺"
"Chelsea -0.5,-1.0 @ 1.980

$200.00 Single",05/18/2021 13:35:02,200,298,98,EPL,1.98,,2195.91,"Chelsea v Leicester(2:1)
欧冠资格生死战, 切尔西技高一筹, 拿捏的死死的
莱斯特主要的问题是瓦尔迪状态下滑, 阵眼巴恩斯长期伤缺"
"Chelsea -0.5,-1.0 @ 1.950

$200.00 Single",05/18/2021 13:55:48,200,295,95,EPL,1.95,,2290.91,"Chelsea v Leicester(2:1)
欧冠资格生死战, 切尔西技高一筹, 拿捏的死死的
莱斯特主要的问题是瓦尔迪状态下滑, 阵眼巴恩斯长期伤缺"
"(1-0) Chelsea 0.0,-0.5 @ 1.820

$100.00 Single",05/18/2021 15:23:58,100,50,-50,EPL,1.82,,2240.91,"Chelsea v Leicester(2:1)
欧冠资格生死战, 切尔西技高一筹, 拿捏的死死的
莱斯特主要的问题是瓦尔迪状态下滑, 阵眼巴恩斯长期伤缺"
"Timo Werner (Anytime) @ 4.33

$20.00 Single",05/18/2021 15:25:16,20,0,-20,EPL,4.33,other,2220.91,"维尔纳进球, 娱乐~~"
"Newcastle -0.5,-1.0 @ 1.980

$119.00 Single",05/18/2021 21:37:16,119,177.31,58.31,EPL,1.98,,2279.22,"Newcastle 1:0 降级队
主场有观众，newcastle踢的还是心不在焉
"
"Everton -0.5 @ 1.900

$100.00 Single",05/18/2021 21:48:28,100,190,90,EPL,1.9,regular,2369.22,
"Newcastle -0.5 @ 1.900

$100.00 Single",05/19/2021 11:14:25,100,161.22,61.22,EPL,1.9,early cashout,2430.44,"Newcastle 1:0 降级队
主场有观众，newcastle踢的还是心不在焉
求稳妥只能early cashout"
"Newcastle -0.5 @ 1.910

$100.00 Single",05/19/2021 11:15:22,100,161.16,61.16,EPL,1.91,early cashout,2491.6,"Newcastle 1:0 降级队
主场有观众，newcastle踢的还是心不在焉
求稳妥只能early cashout"
"Atalanta @ 2.25

$89.69 Single",05/19/2021 14:08:42,89.69,0,-89.69,Serie A,2.25,regular,2401.91,"Atalanta v Juventus(Fulltime Result)
意大利杯决赛, 亚特兰大这队伍基本已经垮了
这个赛季戈麦斯转会, 伊利西奇状态断崖式下滑"
"(0-0) Over 3.0 @ 1.750

$100.00 Single",05/19/2021 14:27:18,100,100,0,,1.75,,2401.91,
"AC Milan 0.0 @ 1.910

$100.00 Single",05/20/2021 10:02:07,100,92.05,-7.95,Serie A,1.91,cash out,2393.96,Atalanta 1:3 AC Milan(Asian Handicap)
"No @ 2.20

$50.00 Single",05/22/2021 9:46:40,50,0,-50,La liga,2.2,BTTS,2343.96,"Real Madrid 2:1 Villarreal(Both Teams to Score)
西甲最后一轮, 本场涉及争冠, 详细分析:
https://www.notion.so/2021-final-round-summary-b1caa6c995a64e639e2fcde5f110e9c9"
"Under 2.5 @ 2.75

$50.00 Single",05/22/2021 9:47:04,50,0,-50,La liga,2.75,goal,2293.96,"Real Madrid v Villarreal(Total Goals)
https://www.notion.so/2021-final-round-summary-b1caa6c995a64e639e2fcde5f110e9c9"
"AC Milan 0.0 @ 2.070

$100.00 Single",05/22/2021 9:55:19,100,207,107,Serie A,2.07,,2400.96,"Atalanta 1:3  AC Milan(Asian Handicap)
末轮欧冠资格战, 故事很多.
详细分析: https://www.notion.so/2021-final-round-summary-b1caa6c995a64e639e2fcde5f110e9c9"
"AC Milan 0.0 @ 2.070

$100.00 Single",05/22/2021 9:55:28,100,207,107,Serie A,2.07,,2507.96,"Atalanta 1:3  AC Milan(Asian Handicap)
末轮欧冠资格战, 故事很多.
详细分析: https://www.notion.so/2021-final-round-summary-b1caa6c995a64e639e2fcde5f110e9c9"
"Man Utd -0.5 @ 1.910

$100.00 Single",05/22/2021 13:05:53,100,95,-5,UCL,1.91,cash out,2502.96,
"Leeds -1.0 @ 1.930

$100.00 Single",05/23/2021 9:20:29,100,193,93,EPL,1.93,,2595.96,"Leeds v West Brom(3:1)
联赛最后一轮，2队都无欲无求, 利兹联主场也是唯一一个有球迷入场的主场, 考虑到这一点还是信了一手
本赛季leeds圆满收官"
"Over 3.0 @ 1.950

$100.00 Single",05/23/2021 9:21:06,100,195,95,EPL,1.95,goal,2690.96,Leicester v Tottenham(Goal Line)
"AC Milan 0.0 @ 2.050

$88.00 Single",05/23/2021 12:21:02,88,83.6,-4.4,Serie A,2.05,cash out,2686.56,
"Juventus -1.5,-2.0 @ 1.980

$200.00 Single",05/23/2021 13:11:46,200,200,0,Serie A,1.98,cash out,2686.56,
"Juventus -2.0 @ 1.900

$100.00 Single",05/23/2021 13:12:24,100,0,-100,Serie A,1.9,corner,2586.56,"尤文欧冠生死战, C罗终于被拿下, 早早领先后开始划水, 最后居然是0角球, 无语
https://www.notion.so/2021-final-round-summary-b1caa6c995a64e639e2fcde5f110e9c9"
"Juventus -2.0 @ 1.900

$100.00 Single",05/23/2021 13:12:37,100,0,-100,Serie A,1.9,corner,2486.56,"尤文欧冠生死战, C罗终于被拿下, 早早领先后开始划水, 最后居然是0角球, 无语
https://www.notion.so/2021-final-round-summary-b1caa6c995a64e639e2fcde5f110e9c9"
"(0-1) AC Milan 0.0 @ 2.375

$75.65 Single",05/23/2021 15:25:45,75.65,179.67,104.02,Serie A,2.375,live,2590.58,
"Chelsea @ 4.33

$43.67 Single",05/24/2021 21:09:48,43.67,189.24,145.57,UCL,4.33,,2736.15,
"(0-0) Man Utd -0.5 @ 1.970

$100.00 Single",05/26/2021 14:21:29,100,0,-100,UCL,1.97,live,2636.15,"Villarreal v Man Utd(1:1)  Villarreal win in penalty shoot out
欧联杯决赛, 曼联踢的有点可疑: 90分钟不换人, 拉师傅和格林伍德踢的很差, 不正常的差
投注纪律: 这种鸡肋杯赛的决赛尽量少碰英超的热门球队"
"(0-0) Man Utd -0.5 @ 1.970

$145.00 Single",05/26/2021 14:22:07,145,0,-145,UCL,1.97,live,2491.15,"Villarreal v Man Utd(1:1)  Villarreal win in penalty shoot out
欧联杯决赛, 曼联踢的有点可疑: 90分钟不换人, 拉师傅和格林伍德踢的很差, 不正常的差
投注纪律: 这种鸡肋杯赛的决赛尽量少碰英超的热门球队"
"Chelsea +2.0 @ 1.900

$300.00 Single",05/27/2021 22:13:29,300,300,0,UCL,1.9,cash out,2491.15,"Man City v Chelsea(0:1)
欧冠决赛, 瓜迪奥拉心魔难除. 我现在越来越理解他的想法了. 想在战术上做到极致, 在战术上讨到便宜. 但是球员的执行力和理解程度未能如意. 这样有时还不如踢一个中庸的战术, 靠球员的能力解决问题"
"Chelsea +0.5 @ 2.010

$100.00 Single",05/27/2021 22:13:48,100,201,101,UCL,2.01,regular,2592.15,"Man City v Chelsea(0:1)
欧冠决赛, 瓜迪奥拉心魔难除. 我现在越来越理解他的想法了. 想在战术上做到极致, 在战术上讨到便宜. 但是球员的执行力和理解程度未能如意. 这样有时还不如踢一个中庸的战术, 靠球员的能力解决问题"
"Chelsea @ 4.70

$100.00 Single",05/27/2021 22:14:01,100,470,370,UCL,4.7,regular,2962.15,"Man City v Chelsea(0:1)
欧冠决赛, 瓜迪奥拉心魔难除. 我现在越来越理解他的想法了. 想在战术上做到极致, 在战术上讨到便宜. 但是球员的执行力和理解程度未能如意. 这样有时还不如踢一个中庸的战术, 靠球员的能力解决问题"
"Chelsea +2.0 @ 1.900

$100.00 Single",05/28/2021 12:20:52,100,100,0,UCL,1.9,corner,2962.15,"Man City v Chelsea(0:1)
欧冠决赛, 瓜迪奥拉心魔难除. 我现在越来越理解他的想法了. 想在战术上做到极致, 在战术上讨到便宜. 但是球员的执行力和理解程度未能如意. 这样有时还不如踢一个中庸的战术, 靠球员的能力解决问题"
"Chelsea 3-2 @ 41.00

$20.00 Single",05/29/2021 13:21:15,20,0,-20,UCL,41,other,2942.15,梦见这个比分，必须走一手