Match,Date,Bet,Return,Gain,Meta,Odds,Balance,Comments,BET_TYPE,BET_STYLE,BET_RESULT,TEAM_1,TEAM_2
"Real Madrid @ 2.30
$20.00 Single",2018-05-26 11:14:25,20.0,46.0,26.0,UCL,2.3,226.0,,FINAL RESULT,PRE MATCH,WIN,Real Madrid,
"GS Warriors -6.5 @ 1.90
$10.00 Single",2018-05-28 08:37:48,10.0,19.1,9.1,NBA,1.9,235.1,,ASIAN HANDICAP,PRE MATCH,WIN,,
"Spain @ 1.95
$50.00 Single",2018-05-29 14:17:23,50.0,50.0,0.0,WC,1.95,235.1,,FINAL RESULT,PRE MATCH,PUSH,,
"GS Warriors -11.5 @ 1.90
$20.00 Single",2018-06-02 13:34:35,20.0,38.19,18.19,NBA,1.9,253.29,,UNKNOWN,PRE MATCH,WIN,,
"England @ 1.44
$20.00 Single",2018-06-12 10:27:39,20.0,20.0,0.0,WC,1.44,253.29,,FINAL RESULT,PRE MATCH,PUSH,,
"Spain @ 2.10
$33.29 Single",2018-06-13 07:16:40,33.29,0.0,-33.29,WC,2.1,220.0,,FINAL RESULT,PRE MATCH,LOST,,
"France @ 1.25
$50.00 Single",2018-06-13 13:46:09,50.0,62.5,12.5,WC,1.25,232.5,,FINAL RESULT,PRE MATCH,WIN,,
"Draw @ 4.50
$5.00 Single",2018-06-13 20:45:55,5.0,4.5,-0.5,WC,4.5,232.0,,FINAL RESULT,PRE MATCH,LOST,,
"Draw @ 4.33
$5.00 Single",2018-06-14 08:26:03,5.0,0.0,-5.0,WC,4.33,227.0,,FINAL RESULT,PRE MATCH,LOST,,
"Egypt @ 9.00
$5.00 Single",2018-06-15 05:45:39,5.0,5.0,0.0,WC,9.0,227.0,,FINAL RESULT,PRE MATCH,PUSH,,
"Draw @ 4.00
$5.00 Single",2018-06-15 06:09:05,5.0,0.0,-5.0,WC,4.0,222.0,,FINAL RESULT,PRE MATCH,LOST,,
"Spain @ 4.33
$10.00 Single",2018-06-15 13:22:37,10.0,0.0,-10.0,WC,4.33,212.0,,FINAL RESULT,PRE MATCH,LOST,,
"Spain @ 4.75
$5.00 Single",2018-06-15 13:58:24,5.0,0.0,-5.0,WC,4.75,207.0,,FINAL RESULT,PRE MATCH,LOST,,
"Draw @ 5.00
$5.00 Single",2018-06-16 06:57:54,5.0,25.0,20.0,WC,5.0,227.0,,FINAL RESULT,PRE MATCH,WIN,,
"Egypt @ 2.37
$27.00 Single",2018-06-16 10:38:17,27.0,0.0,-27.0,WC,2.37,200.0,,FINAL RESULT,PRE MATCH,LOST,,
"Peru @ 19.00
$5.00 Single",2018-06-16 12:20:17,5.0,0.0,-5.0,WC,19.0,195.0,,FINAL RESULT,PRE MATCH,LOST,,
"Peru @ 19.00
$5.00 Single",2018-06-16 12:22:49,5.0,0.0,-5.0,WC,19.0,190.0,,FINAL RESULT,PRE MATCH,LOST,,
"Germany -1.0,-1.5 @ 2.070
$50.00 Single",2018-06-17 05:13:59,50.0,50.0,0.0,WC,2.07,190.0,,ASIAN HANDICAP,PRE MATCH,PUSH,,
"Germany -1.0,-1.5 @ 2.070
$30.00 Single",2018-06-17 05:15:01,30.0,0.0,-30.0,WC,2.07,160.0,,ASIAN HANDICAP,PRE MATCH,LOST,,
"Sweden 0.0,-0.5 @ 1.930
$20.00 Single",2018-06-18 06:35:41,20.0,38.6,18.6,WC,1.93,178.6,,ASIAN HANDICAP,PRE MATCH,WIN,,
"Over 2.5 @ 1.70
$20.00 Single",2018-06-18 09:25:53,20.0,34.0,14.0,WC,1.7,192.6,,TOTAL GOAL,PRE MATCH,WIN,,
"Morocco +0.5,+1.0 @ 2.080
$20.00 Single",2018-06-18 17:47:26,20.0,20.0,0.0,WC,2.08,192.6,,ASIAN HANDICAP,PRE MATCH,PUSH,,
"Egypt +0.5 @ 1.830
$12.60 Single",2018-06-18 18:34:05,12.6,12.6,0.0,WC,1.83,192.6,,ASIAN HANDICAP,PRE MATCH,PUSH,,
"Colombia @ 1.75
$22.60 Single",2018-06-18 20:38:44,22.6,0.0,-22.6,WC,1.75,170.0,,FINAL RESULT,PRE MATCH,LOST,,
"Over 2.0,2.5 @ 1.930
$20.00 Single",2018-06-20 06:44:56,20.0,0.0,-20.0,WC,1.93,150.0,,TOTAL GOAL,PRE MATCH,LOST,,
"Saudi Arabia +1.5,+2.0 @ 1.960
$20.00 Single",2018-06-20 09:55:16,20.0,39.2,19.2,WC,1.96,169.2,,ASIAN HANDICAP,PRE MATCH,WIN,,
"Australia +0.5 @ 1.980
$20.00 Single",2018-06-21 06:37:29,20.0,20.0,0.0,WC,1.98,169.2,,ASIAN HANDICAP,PRE MATCH,PUSH,,
"Australia +0.5 @ 2.010
$20.00 Single",2018-06-21 06:49:41,20.0,40.2,20.2,WC,2.01,189.4,,ASIAN HANDICAP,PRE MATCH,WIN,,
"Over 2.0,2.5 @ 2.125
$20.00 Single",2018-06-21 07:56:04,20.0,0.0,-20.0,WC,2.125,169.4,,TOTAL GOAL,PRE MATCH,LOST,,
"Over 2.0 @ 1.810
$19.40 Single",2018-06-21 09:48:09,19.4,0.0,-19.4,WC,1.81,150.0,,TOTAL GOAL,PRE MATCH,LOST,,
"Serbia @ 3.75
$10.00 Single",2018-06-22 14:29:56,10.0,0.0,-10.0,WC,3.75,140.0,,FINAL RESULT,PRE MATCH,LOST,,
"South Korea +0.5,+1.0 @ 1.920
$20.00 Single",2018-06-23 06:46:37,20.0,19.0,-1.0,WC,1.92,139.0,,ASIAN HANDICAP,PRE MATCH,CASH_OUT,,
"No @ 2.05
$20.00 Single",2018-06-23 09:08:41,20.0,0.0,-20.0,WC,2.05,119.0,,BTTS,PRE MATCH,LOST,,
"No @ 2.05
$19.00 Single",2018-06-23 09:45:02,19.0,0.0,-19.0,WC,2.05,100.0,,BTTS,PRE MATCH,LOST,,
"No @ 1.70
$20.00 Single",2018-06-24 09:51:07,20.0,0.0,-20.0,WC,1.7,80.0,,BTTS,PRE MATCH,LOST,,
"Colombia 0.0,-0.5 @ 1.890
$30.00 Single",2018-06-24 11:54:08,30.0,56.7,26.7,WC,1.89,106.7,,ASIAN HANDICAP,PRE MATCH,WIN,,
"Yes @ 1.95
$20.00 Single",2018-06-24 17:20:21,20.0,39.0,19.0,WC,1.95,125.7,,BTTS,PRE MATCH,WIN,,
"Under 9.5 @ 1.900
$15.70 Single",2018-06-25 12:43:24,15.7,29.83,14.13,WC,1.9,139.83,,TOTAL CORNER,PRE MATCH,WIN,,
"Australia 0.0 @ 1.850
$19.83 Single",2018-06-25 16:25:22,19.83,36.69,16.86,WC,1.85,156.69,,ASIAN HANDICAP,PRE MATCH,WIN,,
"Nigeria @ 6.25
$5.00 Single",2018-06-26 08:15:16,5.0,0.0,-5.0,WC,6.25,151.69,,FINAL RESULT,PRE MATCH,LOST,,
"Nigeria @ 29.00
$1.69 Single",2018-06-26 13:51:31,1.69,0.0,-1.69,WC,29.0,150.0,,FINAL RESULT,PRE MATCH,LOST,,
"No @ 1.90
$20.00 Single",2018-06-26 20:01:11,20.0,20.0,0.0,WC,1.9,150.0,,BTTS,PRE MATCH,PUSH,,
"France 0.0,-0.5 @ 2.040
$30.00 Single",2018-06-26 20:48:13,30.0,61.2,31.2,WC,2.04,181.2,,ASIAN HANDICAP,PRE MATCH,WIN,,
"France @ 2.40
$20.00 Single",2018-06-26 21:06:07,20.0,48.0,28.0,WC,2.4,209.2,,FINAL RESULT,PRE MATCH,WIN,,
"France 0.0,-0.5 @ 1.990
$20.00 Single",2018-06-27 05:49:29,20.0,39.8,19.8,WC,1.99,229.0,,ASIAN HANDICAP,PRE MATCH,WIN,,
"Sweden -0.5 @ 1.975
$20.00 Single",2018-06-27 08:00:28,20.0,0.0,-20.0,WC,1.975,209.0,,ASIAN HANDICAP,PRE MATCH,LOST,,
"Serbia 1-0 @ 21.00
$5.00 Single",2018-06-27 12:57:35,5.0,0.0,-5.0,WC,21.0,204.0,,FINAL SCORE,PRE MATCH,LOST,,
"Serbia @ 29.00
$5.00 Single",2018-06-27 14:15:34,5.0,0.0,-5.0,WC,29.0,199.0,,FINAL RESULT,PRE MATCH,LOST,,
"France 0.0,-0.5 @ 2.040
$30.00 Single",2018-06-30 08:20:07,30.0,61.2,31.2,WC,2.04,230.2,,ASIAN HANDICAP,PRE MATCH,WIN,,
"France @ 2.37
$20.00 Single",2018-06-30 08:25:29,20.0,47.5,27.5,WC,2.37,257.7,,FINAL RESULT,PRE MATCH,WIN,,
"Uruguay 0.0 @ 2.010
$30.00 Single",2018-06-30 11:33:38,30.0,60.3,30.3,WC,2.01,288.0,,ASIAN HANDICAP,PRE MATCH,WIN,,
"Under 9.0 @ 2.10
$20.00 Single",2018-06-30 11:53:01,20.0,0.0,-20.0,WC,2.1,268.0,,TOTAL CORNER,PRE MATCH,LOST,,
"Russia -1.0 @ 1.850
$18.00 Single",2018-07-01 05:12:18,18.0,18.0,0.0,WC,1.85,268.0,,ASIAN HANDICAP,PRE MATCH,PUSH,,
"Spain @ 1.80
$18.00 Single",2018-07-01 11:34:44,18.0,0.0,-18.0,WC,1.8,250.0,,FINAL RESULT,PRE MATCH,LOST,,
"Denmark +0.5 @ 1.960
$30.00 Single",2018-07-01 12:15:40,30.0,58.8,28.8,WC,1.96,278.8,,ASIAN HANDICAP,PRE MATCH,WIN,,
"Denmark +0.5 @ 1.940
$20.00 Single",2018-07-01 12:48:17,20.0,38.8,18.8,WC,1.94,297.6,,ASIAN HANDICAP,PRE MATCH,WIN,,
"Brazil -1.0 @ 1.810
$30.00 Single",2018-07-02 08:10:05,30.0,30.0,0.0,WC,1.81,297.6,,ASIAN HANDICAP,PRE MATCH,PUSH,,
"Mexico -1.0 @ 2.000
$20.00 Single",2018-07-02 08:10:24,20.0,40.0,20.0,WC,2.0,317.6,,ASIAN HANDICAP,PRE MATCH,WIN,,
"Brazil -1.0 @ 1.800
$30.00 Single",2018-07-02 08:21:06,30.0,54.0,24.0,WC,1.8,341.6,,ASIAN HANDICAP,PRE MATCH,WIN,,
"Brazil -0.5 @ 2.110
$41.60 Single",2018-07-02 15:57:15,41.6,41.6,0.0,WC,2.11,341.6,,ASIAN HANDICAP,PRE MATCH,PUSH,,
"France -0.5 @ 2.000
$50.00 Single",2018-07-02 16:12:02,50.0,100.0,50.0,WC,2.0,391.6,,ASIAN HANDICAP,PRE MATCH,WIN,,
"No @ 1.66
$41.60 Single",2018-07-02 19:26:31,41.6,69.34,27.74,WC,1.66,419.34,,BTTS,PRE MATCH,WIN,,
"England -1.5 @ 1.900
$20.00 Single",2018-07-03 06:53:21,20.0,38.0,18.0,WC,1.9,437.34,,ASIAN HANDICAP,PRE MATCH,WIN,,
"Antoine Griezmann @ 21.00
$4.34 Single",2018-07-03 12:26:42,4.34,0.0,-4.34,WC,21.0,433.0,,FINAL RESULT,PRE MATCH,LOST,,
"France -0.5 @ 1.775
$45.00 Single",2018-07-03 13:55:27,45.0,0.0,-45.0,WC,1.775,388.0,,ASIAN HANDICAP,PRE MATCH,LOST,,
"France -1.0 @ 1.925
$38.00 Single",2018-07-04 06:06:00,38.0,38.0,0.0,WC,1.925,388.0,,ASIAN HANDICAP,PRE MATCH,PUSH,,
"England -0.5 @ 1.960
$50.00 Single",2018-07-04 06:28:48,50.0,98.0,48.0,WC,1.96,436.0,,ASIAN HANDICAP,PRE MATCH,WIN,,
"No @ 1.61
$18.00 Single",2018-07-05 08:06:16,18.0,29.08,11.08,WC,1.61,447.08,,BTTS,PRE MATCH,WIN,,
"Brazil 0.0,-0.5 @ 1.840
$30.00 Single",2018-07-05 19:47:53,30.0,0.0,-30.0,WC,1.84,417.08,,ASIAN HANDICAP,PRE MATCH,LOST,,
"Draw 2-2 @ 23.00
$5.00 Single",2018-07-06 06:52:16,5.0,5.0,0.0,WC,23.0,417.08,,FINAL SCORE,PRE MATCH,PUSH,,
"Draw 2-2 @ 17.00
$5.00 Single",2018-07-06 06:52:51,5.0,0.0,-5.0,WC,17.0,412.08,,FINAL SCORE,PRE MATCH,LOST,,
"Brazil -0.5 @ 2.110
$24.08 Single",2018-07-06 11:11:49,24.08,0.0,-24.08,WC,2.11,388.0,,ASIAN HANDICAP,PRE MATCH,LOST,,
"Brazil -0.5 @ 2.125
$50.00 Single",2018-07-06 11:58:05,50.0,0.0,-50.0,WC,2.125,338.0,,ASIAN HANDICAP,PRE MATCH,LOST,,
"England -0.5 @ 1.900
$100.00 Single",2018-07-07 06:54:49,100.0,190.0,90.0,WC,1.9,428.0,,ASIAN HANDICAP,PRE MATCH,WIN,,
"France 0.0,-0.5 @ 2.125
$100.00 Single",2018-07-07 06:57:38,100.0,100.0,0.0,WC,2.125,428.0,,ASIAN HANDICAP,PRE MATCH,PUSH,,
"No @ 1.66
$50.00 Single",2018-07-07 08:58:55,50.0,62.5,12.5,WC,1.66,440.5,,BTTS,PRE MATCH,WIN,,
"Under 7.5 @ 1.57
$20.00 Single",2018-07-07 15:39:17,20.0,31.43,11.43,WC,1.57,451.93,,TOTAL CORNER,PRE MATCH,WIN,,
"France 0.0,-0.5 @ 2.125
$21.93 Single",2018-07-07 20:18:35,21.93,36.57,14.64,WC,2.125,466.57,,ASIAN HANDICAP,PRE MATCH,WIN,,
"England 0.0,-0.5 @ 2.040
$30.00 Single",2018-07-07 20:19:05,30.0,15.0,-15.0,WC,2.04,451.57,,ASIAN HANDICAP,PRE MATCH,LOST,,
"England 0.0,-0.5 @ 1.990
$20.00 Single",2018-07-08 20:38:57,20.0,20.0,0.0,WC,1.99,451.57,,ASIAN HANDICAP,PRE MATCH,PUSH,,
"France 0.0,-0.5 @ 2.110
$30.00 Single",2018-07-08 20:40:20,30.0,63.3,33.3,WC,2.11,484.87,,ASIAN HANDICAP,PRE MATCH,WIN,,
"Belgium +0.5 @ 1.750
$30.00 Single",2018-07-09 09:57:44,30.0,30.0,0.0,WC,1.75,484.87,,ASIAN HANDICAP,PRE MATCH,PUSH,,
"No @ 2.00
$30.00 Single",2018-07-10 09:44:06,30.0,60.0,30.0,WC,2.0,514.87,,BTTS,PRE MATCH,WIN,,
"Raheem Sterling @ 4.00
$9.87 Single",2018-07-10 20:52:07,9.87,0.0,-9.87,WC,4.0,505.0,,FINAL RESULT,PRE MATCH,LOST,,
"France -0.5 @ 1.950
$65.00 Single",2018-07-11 22:46:23,65.0,126.75,61.75,WC,1.95,566.75,,ASIAN HANDICAP,PRE MATCH,WIN,,
"Under 3.5 @ 1.700
$50.00 Single",2018-07-13 08:59:41,50.0,85.0,35.0,WC,1.7,601.75,,TOTAL GOAL,PRE MATCH,WIN,,
"France -0.5 @ 2.160
$35.00 Single",2018-07-15 09:38:52,35.0,75.6,40.6,WC,2.16,642.35,,ASIAN HANDICAP,PRE MATCH,WIN,,
"Draw @ 3.00
$50.00 Single (50.00 Free In-Play Bet)
Free In-Play Bet Redeemed",2018-07-15 10:01:42,50.0,0.0,-50.0,WC,3.0,592.35,,FINAL RESULT,PRE MATCH,LOST,,
"Beijing Guoan @ 1.57
$52.35 Single",2018-07-21 11:39:49,52.35,52.35,0.0,CSL,1.57,592.35,,FINAL RESULT,PRE MATCH,PUSH,,
"Beijing Guoan @ 1.57
$22.35 Single",2018-07-21 11:40:15,22.35,35.13,12.78,CSL,1.57,605.13,,FINAL RESULT,PRE MATCH,WIN,,
"Beijing Guoan @ 1.57
$3.00 Single",2018-07-22 06:19:27,3.0,4.72,1.72,CSL,1.57,606.85,,FINAL RESULT,PRE MATCH,WIN,,
"Beijing Guoan @ 1.57
$27.00 Single",2018-07-22 06:19:38,27.0,42.43,15.43,CSL,1.57,622.28,,FINAL RESULT,PRE MATCH,WIN,,
"Beijing Guoan +0.5 @ 2.000
$12.28 Single",2018-07-24 21:03:45,12.28,0.0,-12.28,CSL,2.0,610.0,,ASIAN HANDICAP,PRE MATCH,LOST,,
"Shanghai Shenhua 0.0,+0.5 @ 1.775
$50.00 Single",2018-07-28 06:55:38,50.0,69.38,19.38,CSL,1.775,629.38,,ASIAN HANDICAP,PRE MATCH,WIN,Shanghai Shenhua,
"Shandong Luneng @ 1.66
$29.38 Single",2018-07-30 17:52:30,29.38,48.97,19.59,CSL,1.66,648.97,,FINAL RESULT,PRE MATCH,WIN,,
"Beijing Guoan -1.0 @ 1.900
$18.97 Single",2018-08-02 06:28:28,18.97,36.05,17.08,CSL,1.9,666.05,,ASIAN HANDICAP,PRE MATCH,WIN,,
"Shandong Luneng 0.0,+0.5 @ 2.150
$26.05 Single",2018-08-02 17:34:06,26.05,41.03,14.98,CSL,2.15,681.03,,ASIAN HANDICAP,PRE MATCH,WIN,,
"Shandong Luneng +0.5 @ 1.875
$20.00 Single",2018-08-03 20:05:16,20.0,37.5,17.5,CSL,1.875,698.53,,ASIAN HANDICAP,PRE MATCH,WIN,,
"No @ 2.25
$30.00 Single",2018-08-08 21:00:48,30.0,67.5,37.5,CSL,2.25,736.03,,BTTS,PRE MATCH,WIN,,
"No @ 2.20
$28.53 Single",2018-08-08 21:03:20,28.53,62.77,34.24,CSL,2.2,770.27,,BTTS,PRE MATCH,WIN,,
"No @ 2.00
$30.00 Single",2018-08-08 22:49:12,30.0,30.0,0.0,CSL,2.0,770.27,,BTTS,PRE MATCH,PUSH,,
"Beijing Renhe @ 2.10
$20.27 Single",2018-08-11 16:46:59,20.27,0.0,-20.27,CSL,2.1,750.0,,FINAL RESULT,PRE MATCH,LOST,,
"Shandong Luneng @ 7.00
$10.00 Single",2018-08-13 06:09:51,10.0,0.0,-10.0,CSL,7.0,740.0,,FINAL RESULT,PRE MATCH,LOST,,
"Under 3.0 @ 2.250
$30.00 Single",2018-08-13 17:38:35,30.0,30.0,0.0,CSL,2.25,740.0,,TOTAL GOAL,PRE MATCH,PUSH,,
"Under 3.0 @ 2.250
$30.00 Single",2018-08-13 19:26:09,30.0,30.0,0.0,CSL,2.25,740.0,,TOTAL GOAL,PRE MATCH,PUSH,,
"Tianjin Teda 0.0,+0.5 @ 1.875
$70.00 Single",2018-08-13 20:49:30,70.0,100.63,30.63,CSL,1.875,770.63,,ASIAN HANDICAP,PRE MATCH,WIN,,
"PSG.LGD @ 1.50
$30.00 Single",2018-08-14 07:37:38,30.0,45.0,15.0,TI,1.5,785.63,,FINAL RESULT,PRE MATCH,WIN,Paris SG,
"Under 101.5 @ 1.83
$30.00 Single",2018-08-15 06:45:07,30.0,0.0,-30.0,TI,1.83,755.63,,UNKNOWN,PRE MATCH,LOST,,
"Tianjin Quanjian +2.5 @ 2.100
$15.63 Single",2018-08-17 08:19:04,15.63,0.0,-15.63,CSL,2.1,740.0,,ASIAN HANDICAP,PRE MATCH,LOST,,
"Newbee @ 2.25
$20.00 Single",2018-08-17 14:24:19,20.0,0.0,-20.0,TI,2.25,720.0,,FINAL RESULT,PRE MATCH,LOST,,
"No @ 2.05
$30.00 Single",2018-08-18 06:32:12,30.0,0.0,-30.0,CSL,2.05,690.0,,BTTS,PRE MATCH,LOST,,
"Over 2.5 @ 1.600
$50.00 Single",2018-08-20 08:20:51,50.0,0.0,-50.0,CSL,1.6,640.0,,TOTAL GOAL,PRE MATCH,LOST,,
"fnatic @ 1.57
$30.00 Single",2018-08-20 12:56:59,30.0,0.0,-30.0,TI,1.57,610.0,,FINAL RESULT,PRE MATCH,LOST,,
"PSG.LGD @ 1.80
$20.00 Single",2018-08-20 16:33:50,20.0,36.0,16.0,TI,1.8,626.0,,FINAL RESULT,PRE MATCH,WIN,Paris SG,
"fnatic @ 1.66
$26.00 Single",2018-08-20 17:42:03,26.0,0.0,-26.0,TI,1.66,600.0,,FINAL RESULT,PRE MATCH,LOST,,
"Mineski @ 2.00
$30.00 Single",2018-08-20 19:29:29,30.0,60.0,30.0,TI,2.0,630.0,,FINAL RESULT,PRE MATCH,WIN,,
"Mineski @ 2.10
$30.00 Single",2018-08-20 19:30:06,30.0,63.0,33.0,TI,2.1,663.0,,FINAL RESULT,PRE MATCH,WIN,,
"Newbee @ 1.44
$23.00 Single",2018-08-20 20:57:43,23.0,0.0,-23.0,TI,1.44,640.0,,FINAL RESULT,PRE MATCH,LOST,,
"VGJ.Thunder @ 2.25
$30.00 Single",2018-08-20 22:30:51,30.0,0.0,-30.0,TI,2.25,610.0,,FINAL RESULT,PRE MATCH,LOST,,
"Over 2.5 @ 1.72
$20.00 Single",2018-08-21 06:37:14,20.0,0.0,-20.0,CSL,1.72,590.0,,TOTAL GOAL,PRE MATCH,LOST,,
"Virtus Pro @ 12.00
$10.00 Single",2018-08-22 07:24:46,10.0,0.0,-10.0,TI,12.0,580.0,,FINAL RESULT,PRE MATCH,LOST,,
"Team Secret @ 1.72
$40.00 Single",2018-08-22 15:03:21,40.0,69.1,29.1,TI,1.72,609.1,,FINAL RESULT,PRE MATCH,WIN,,
"Team Secret @ 1.57
$50.00 Single",2018-08-22 15:24:32,50.0,0.0,-50.0,TI,1.57,559.1,,FINAL RESULT,PRE MATCH,LOST,,
"Team Secret @ 1.83
$50.00 Single",2018-08-22 17:47:19,50.0,91.67,41.67,TI,1.83,600.77,,FINAL RESULT,PRE MATCH,WIN,,
"Team Liquid @ 1.66
$20.00 Single",2018-08-22 20:22:49,20.0,0.0,-20.0,TI,1.66,580.77,,FINAL RESULT,PRE MATCH,LOST,,
"Team Liquid @ 1.90
$20.77 Single",2018-08-22 20:27:35,20.77,0.0,-20.77,TI,1.9,560.0,,FINAL RESULT,PRE MATCH,LOST,,
"OG @ 1.80
$20.00 Single",2018-08-22 23:40:58,20.0,0.0,-20.0,TI,1.8,540.0,,FINAL RESULT,PRE MATCH,LOST,,
"Team Secret @ 1.61
$30.00 Single",2018-08-23 17:21:59,30.0,48.47,18.47,TI,1.61,558.47,,FINAL RESULT,PRE MATCH,WIN,,
"Virtus Pro @ 1.83
$48.47 Single",2018-08-23 20:05:23,48.47,0.0,-48.47,TI,1.83,510.0,,FINAL RESULT,PRE MATCH,LOST,,
"Virtus Pro @ 2.00
$20.00 Single",2018-08-23 21:10:37,20.0,0.0,-20.0,TI,2.0,490.0,,FINAL RESULT,PRE MATCH,LOST,,
"OG @ 2.37
$20.00 Single",2018-08-24 17:18:20,20.0,0.0,-20.0,TI,2.37,470.0,,FINAL RESULT,PRE MATCH,LOST,,
"OG @ 2.50
$30.00 Single",2018-08-24 18:18:06,30.0,75.0,45.0,TI,2.5,515.0,,FINAL RESULT,PRE MATCH,WIN,,
"Evil Geniuses @ 2.00
$25.00 Single",2018-08-24 19:52:35,25.0,50.0,25.0,TI,2.0,540.0,,FINAL RESULT,PRE MATCH,WIN,,
"Evil Geniuses @ 1.90
$20.00 Single",2018-08-24 19:56:33,20.0,38.19,18.19,TI,1.9,558.19,,FINAL RESULT,PRE MATCH,WIN,,
"Team Liquid @ 1.57
$18.19 Single",2018-08-24 21:31:59,18.19,0.0,-18.19,TI,1.57,540.0,,FINAL RESULT,PRE MATCH,LOST,,
"Team Liquid @ 1.53
$20.00 Single",2018-08-24 21:34:09,20.0,0.0,-20.0,TI,1.53,520.0,,FINAL RESULT,PRE MATCH,LOST,,
"Under 3.0,3.5 @ 1.925
$30.00 Single",2018-08-25 06:27:34,30.0,0.0,-30.0,CSL,1.925,490.0,,TOTAL GOAL,PRE MATCH,LOST,,
"Evil Geniuses @ 2.00
$20.00 Single",2018-08-25 12:58:14,20.0,0.0,-20.0,TI,2.0,470.0,,FINAL RESULT,PRE MATCH,LOST,,
"OG @ 2.25
$30.00 Single",2018-08-25 16:22:58,30.0,67.5,37.5,TI,2.25,507.5,,FINAL RESULT,PRE MATCH,WIN,,
"OG @ 2.20
$17.50 Single",2018-08-25 18:41:30,17.5,0.0,-17.5,TI,2.2,490.0,,FINAL RESULT,PRE MATCH,LOST,,
"PSG.LGD @ 1.40
$50.00 Single",2018-08-25 19:47:26,50.0,0.0,-50.0,TI,1.4,440.0,,FINAL RESULT,PRE MATCH,LOST,Paris SG,
"Jiangsu Suning FC @ 1.50
$100.00 Single",2018-08-29 20:36:38,100.0,0.0,-100.0,CSL,1.5,340.0,,FINAL RESULT,PRE MATCH,LOST,,
"Shandong Luneng -0.5 @ 1.925
$50.00 Single",2018-08-29 20:38:43,50.0,50.0,0.0,CSL,1.925,340.0,,ASIAN HANDICAP,PRE MATCH,PUSH,,
"Shanghai SIPG -0.5,-1.0 @ 2.050
$50.00 Single",2018-08-29 20:55:55,50.0,0.0,-50.0,CSL,2.05,290.0,,ASIAN HANDICAP,PRE MATCH,LOST,,
"Draw @ 5.00
$30.00 Single",2018-09-13 17:54:07,30.0,30.0,0.0,CSL,5.0,290.0,,FINAL RESULT,PRE MATCH,PUSH,,
"Beijing Guoan @ 6.00
$20.00 Single",2018-09-13 17:54:19,20.0,20.0,0.0,CSL,6.0,290.0,,FINAL RESULT,PRE MATCH,PUSH,,
"Beijing Guoan @ 6.00
$20.00 Single",2018-09-13 17:55:22,20.0,0.0,-20.0,CSL,6.0,270.0,,FINAL RESULT,PRE MATCH,LOST,,
"Beijing Guoan +1.0 @ 2.100
$30.00 Single",2018-09-13 17:55:35,30.0,30.0,0.0,CSL,2.1,270.0,,ASIAN HANDICAP,PRE MATCH,PUSH,,
"Draw @ 3.80
$30.00 Single",2018-09-18 06:26:58,30.0,30.0,0.0,CSL,3.8,270.0,,FINAL RESULT,PRE MATCH,PUSH,,
"Shanghai SIPG @ 2.62
$30.00 Single",2018-09-18 06:30:58,30.0,30.0,0.0,CSL,2.62,270.0,,FINAL RESULT,PRE MATCH,PUSH,,
"Shanghai SIPG 0.0 @ 1.925
$30.00 Single",2018-09-18 06:31:50,30.0,57.75,27.75,CSL,1.925,297.75,,ASIAN HANDICAP,PRE MATCH,WIN,,
"Hebei CFFC -1.0 @ 1.975
$50.00 Single",2018-09-20 09:15:41,50.0,50.0,0.0,CSL,1.975,297.75,,ASIAN HANDICAP,PRE MATCH,PUSH,,
"Hebei CFFC -1.0 @ 1.925
$30.00 Single",2018-09-21 08:18:53,30.0,57.75,27.75,CSL,1.925,325.5,,ASIAN HANDICAP,PRE MATCH,WIN,,
"Hebei CFFC @ 1.55
$20.00 Single",2018-09-21 08:19:06,20.0,31.0,11.0,CSL,1.55,336.5,,FINAL RESULT,PRE MATCH,WIN,,
"Under 2.5 @ 2.000
$16.50 Single",2018-09-22 22:46:56,16.5,0.0,-16.5,CSL,2.0,320.0,,TOTAL GOAL,PRE MATCH,LOST,,
"Yes @ 1.72
$100.00 Single",2018-09-26 06:30:38,100.0,0.0,-100.0,CSL,1.72,220.0,,BTTS,PRE MATCH,LOST,,
"Arsenal @ 3.00
$20.00 Single",2018-12-04 18:36:51,20.0,0.0,-20.0,PL,3.0,200.0,,FINAL RESULT,PRE MATCH,LOST,Arsenal,
"Arsenal @ 4.33
$10.00 Single",2018-12-05 16:24:18,10.0,0.0,-10.0,PL,4.33,190.0,,FINAL RESULT,PRE MATCH,LOST,Arsenal,
"No @ 1.57
$20.00 Single",2019-01-15 17:46:54,20.0,31.43,11.43,AFC,1.57,201.43,,BTTS,PRE MATCH,WIN,,
"South Korea @ 1.57
$20.00 Single",2019-01-15 23:01:18,20.0,31.43,11.43,AFC,1.57,212.86,,FINAL RESULT,PRE MATCH,WIN,,
"China PR @ 2.00
$32.86 Single",2019-01-17 06:31:15,32.86,65.72,32.86,AFC,2.0,245.72,,FINAL RESULT,PRE MATCH,WIN,,
"Under 2.5 @ 1.57
$10.00 Single",2019-01-19 23:11:31,10.0,0.0,-10.0,AFC,1.57,235.72,,TOTAL GOAL,PRE MATCH,LOST,,
"Under 2.0 @ 2.025
$10.00 Single",2019-01-19 23:11:53,10.0,0.0,-10.0,AFC,2.025,225.72,,TOTAL GOAL,PRE MATCH,LOST,,
"No @ 1.75
$15.72 Single",2019-01-21 05:29:35,15.72,27.51,11.79,AFC,1.75,237.51,,BTTS,PRE MATCH,WIN,,
"No @ 1.75
$10.00 Single",2019-01-21 05:30:44,10.0,17.5,7.5,AFC,1.75,245.01,,BTTS,PRE MATCH,WIN,,
"Australia @ 1.95
$25.01 Single",2019-01-21 18:12:35,25.01,25.01,0.0,AFC,1.95,245.01,,FINAL RESULT,PRE MATCH,PUSH,,
"Australia -0.5 @ 1.990
$20.00 Single",2019-01-21 18:13:23,20.0,0.0,-20.0,AFC,1.99,225.01,,ASIAN HANDICAP,PRE MATCH,LOST,,
"Over 2.0 @ 1.775
$30.00 Single",2019-01-23 05:27:08,30.0,53.25,23.25,AFC,1.775,248.26,,TOTAL GOAL,PRE MATCH,WIN,,
"Japan -1.5 @ 2.050
$20.00 Single",2019-01-23 21:15:44,20.0,0.0,-20.0,AFC,2.05,228.26,,ASIAN HANDICAP,PRE MATCH,LOST,,
"Iran -0.5 @ 2.000
$25.01 Single",2019-01-24 10:17:41,25.01,50.02,25.01,AFC,2.0,253.27,,ASIAN HANDICAP,PRE MATCH,WIN,,
"Japan 0.0,+0.5 @ 1.940
$23.27 Single",2019-01-25 09:58:35,23.27,45.15,21.88,AFC,1.94,275.15,,ASIAN HANDICAP,PRE MATCH,WIN,,
"Japan 0.0,+0.5 @ 1.970
$10.00 Single",2019-01-25 13:38:24,10.0,19.7,9.7,AFC,1.97,284.85,,ASIAN HANDICAP,PRE MATCH,WIN,,
"Japan 0.0,+0.5 @ 1.980
$20.00 Single",2019-01-27 08:33:53,20.0,39.6,19.6,AFC,1.98,304.45,,ASIAN HANDICAP,PRE MATCH,WIN,,
"Over 2.0 @ 2.000
$14.45 Single",2019-01-29 08:58:27,14.45,28.9,14.45,AFC,2.0,318.9,,TOTAL GOAL,PRE MATCH,WIN,,
"Japan 0.0,-0.5 @ 1.910
$20.00 Single",2019-01-31 17:29:32,20.0,20.0,0.0,AFC,1.91,318.9,,ASIAN HANDICAP,PRE MATCH,PUSH,,
"Japan 0.0,-0.5 @ 1.910
$27.10 Single",2019-01-31 18:37:49,27.1,27.1,0.0,AFC,1.91,318.9,,ASIAN HANDICAP,PRE MATCH,PUSH,,
"Japan -0.5 @ 1.775
$50.00 Single",2019-02-01 08:21:52,50.0,88.75,38.75,AFC,1.775,357.65,,ASIAN HANDICAP,PRE MATCH,WIN,,
"Japan -0.5 @ 1.775
$7.10 Single",2019-02-01 08:27:07,7.1,12.61,5.51,AFC,1.775,363.16,,ASIAN HANDICAP,PRE MATCH,WIN,,
"Atletico Madrid 0.0 @ 1.840
$21.36 Single",2019-02-01 23:09:37,21.36,39.31,17.95,UCL,1.84,381.11,,ASIAN HANDICAP,PRE MATCH,WIN,Atletico Madrid,
"Real Madrid +0.5,+1.0 @ 1.900
$20.00 Single",2019-02-06 11:02:30,20.0,20.0,0.0,La Liga,1.9,381.11,,ASIAN HANDICAP,PRE MATCH,PUSH,Real Madrid,
"No @ 1.95
$20.00 Single",2019-02-09 04:31:32,20.0,0.0,-20.0,La Liga,1.95,361.11,,BTTS,PRE MATCH,LOST,,
"Man Utd 0.0,-0.5 @ 2.040
$50.00 Single",2019-02-11 15:04:38,50.0,0.0,-50.0,UCL,2.04,311.11,,ASIAN HANDICAP,PRE MATCH,LOST,Manchester United,
"Atletico Madrid 0.0 @ 2.040
$20.00 Single",2019-02-19 19:51:42,20.0,40.8,20.8,UCL,2.04,331.91,,ASIAN HANDICAP,PRE MATCH,WIN,Atletico Madrid,
"Liverpool +0.5 @ 1.860
$20.00 Single",2019-02-21 00:00:47,20.0,20.0,0.0,PL,1.86,331.91,,ASIAN HANDICAP,PRE MATCH,PUSH,Liverpool,
"Liverpool @ 1.90
$20.00 Single",2019-02-24 09:32:57,20.0,0.0,-20.0,PL,1.9,311.91,,FINAL RESULT,PRE MATCH,LOST,Liverpool,
"Man City @ 1.30
$100.00 Single",2019-02-24 11:31:07,100.0,130.0,30.0,PL,1.3,341.91,,FINAL RESULT,PRE MATCH,WIN,Manchester City,
"AC Milan 0.0 @ 2.125
$20.00 Single",2019-02-25 21:41:57,20.0,20.0,0.0,Serie A,2.125,341.91,,ASIAN HANDICAP,PRE MATCH,PUSH,AC Milan,
"Tottenham 0.0,+0.5 @ 1.890
$30.00 Single",2019-02-27 09:30:21,30.0,0.0,-30.0,PL,1.89,311.91,,ASIAN HANDICAP,PRE MATCH,LOST,Tottenham,
"Real Madrid @ 2.10
$20.00 Single",2019-02-27 13:30:06,20.0,20.0,0.0,La Liga,2.1,311.91,,FINAL RESULT,PRE MATCH,PUSH,Real Madrid,
"Under 3.0,3.5 @ 1.825
$20.00 Single",2019-02-27 13:30:32,20.0,28.25,8.25,Serie A,1.825,320.16,,TOTAL GOAL,PRE MATCH,WIN,,
"Real Madrid 0.0 @ 2.080
$28.25 Single",2019-03-01 07:56:57,28.25,0.0,-28.25,La Liga,2.08,291.91,,ASIAN HANDICAP,PRE MATCH,LOST,Real Madrid,
"Under 3.0,3.5 @ 1.910
$20.00 Single",2019-03-01 07:57:49,20.0,38.2,18.2,Serie A,1.91,310.11,,TOTAL GOAL,PRE MATCH,WIN,,
"Arsenal @ 2.00
$30.00 Single",2019-03-02 07:54:43,30.0,0.0,-30.0,Serie A,2.0,280.11,,FINAL RESULT,PRE MATCH,LOST,Arsenal,
"Real Madrid @ 5.00
$20.00 Single",2019-03-02 15:15:18,20.0,0.0,-20.0,La Liga,5.0,260.11,,FINAL RESULT,PRE MATCH,LOST,Real Madrid,
"Ajax +1.0 @ 1.910
$118.00 Single",2019-03-05 09:31:35,118.0,118.0,0.0,UCL,1.91,260.11,,ASIAN HANDICAP,PRE MATCH,PUSH,,
"Ajax +1.0 @ 1.800
$100.00 Single",2019-03-05 12:46:03,100.0,180.0,80.0,UCL,1.8,340.11,,ASIAN HANDICAP,PRE MATCH,WIN,,
"Under 4.5 @ 1.72
$18.20 Single",2019-03-06 13:49:09,18.2,31.44,13.24,UCL,1.72,353.35,,TOTAL GOAL,PRE MATCH,WIN,,
"FC Porto @ 2.00
$20.00 Single",2019-03-06 16:06:53,20.0,40.0,20.0,UCL,2.0,373.35,,FINAL RESULT,PRE MATCH,WIN,,
"Atletico Madrid +0.5,+1.0 @ 1.900
$21.44 Single",2019-03-12 14:01:49,21.44,0.0,-21.44,UCL,1.9,351.91,,ASIAN HANDICAP,PRE MATCH,LOST,Atletico Madrid,
"Under 2.5 @ 2.010
$30.00 Single",2019-03-13 09:48:59,30.0,0.0,-30.0,UCL,2.01,321.91,,TOTAL GOAL,PRE MATCH,LOST,,
"Lyon @ 13.00
$10.00 Single",2019-03-13 14:31:19,10.0,0.0,-10.0,UCL,13.0,311.91,,FINAL RESULT,PRE MATCH,LOST,,
"No @ 2.10
$10.00 Single",2019-03-13 14:31:52,10.0,0.0,-10.0,UCL,2.1,301.91,,BTTS,PRE MATCH,LOST,,
"No @ 2.10
$10.00 Single",2019-03-13 14:32:24,10.0,0.0,-10.0,UCL,2.1,291.91,,BTTS,PRE MATCH,LOST,,
"Ajax @ 3.60
$30.00 Single",2019-03-18 09:13:09,30.0,0.0,-30.0,UCL,3.6,261.91,,FINAL RESULT,PRE MATCH,LOST,,
"Ajax +0.5 @ 1.850
$50.00 Single",2019-03-18 09:13:25,50.0,92.5,42.5,UCL,1.85,304.41,,ASIAN HANDICAP,PRE MATCH,WIN,,
"Ajax @ 3.50
$50.00 Single",2019-04-08 22:33:17,50.0,175.0,125.0,UCL,3.5,429.41,,FINAL RESULT,PRE MATCH,WIN,,
"Ajax @ 3.50
$20.00 Single",2019-04-10 15:17:34,20.0,0.0,-20.0,UCL,3.5,409.41,,FINAL RESULT,PRE MATCH,LOST,,
"Ajax @ 4.75
$22.50 Single",2019-04-10 20:21:12,22.5,106.88,84.38,UCL,4.75,493.79,,FINAL RESULT,PRE MATCH,WIN,,
"(0-0) Chelsea +0.5,+1.0 @ 1.970
$20.00 Single",2019-04-14 10:23:31,20.0,0.0,-20.0,PL,1.97,473.79,,ASIAN HANDICAP,LIVE,LOST,Chelsea,
"Ajax @ 5.00
$20.00 Single",2019-04-16 15:19:56,20.0,100.0,80.0,PL,5.0,553.79,,FINAL RESULT,PRE MATCH,WIN,,
"Under 2.5 @ 1.990
$21.88 Single",2019-04-17 13:32:40,21.88,0.0,-21.88,UCL,1.99,531.91,,TOTAL GOAL,PRE MATCH,LOST,,
"Liverpool +0.5,+1.0 @ 1.960
$50.00 Single",2019-04-17 20:23:34,50.0,0.0,-50.0,UCL,1.96,481.91,,ASIAN HANDICAP,PRE MATCH,LOST,Liverpool,
"Arsenal @ 1.95
$20.00 Single",2019-04-18 14:40:16,20.0,39.05,19.05,UCL,1.95,500.96,,FINAL RESULT,PRE MATCH,WIN,Arsenal,
"No @ 1.95
$29.05 Single",2019-04-19 21:49:35,29.05,56.65,27.6,UCL,1.95,528.56,,BTTS,PRE MATCH,WIN,,
"Man City @ 1.44
$30.00 Single (10.00 Bet Credits + 20.00 CAD)",2019-04-23 09:30:45,30.0,43.34,13.34,PL,1.44,541.9,,FINAL RESULT,PRE MATCH,WIN,Manchester City,
"Chelsea 0.0 @ 1.990
$20.00 Single",2019-04-27 19:10:22,20.0,20.0,0.0,PL,1.99,541.9,,ASIAN HANDICAP,PRE MATCH,PUSH,Chelsea,
"Over 2.5 @ 1.90
$29.99 Single",2019-04-28 16:01:45,29.99,0.0,-29.99,PL,1.9,511.91,,TOTAL GOAL,PRE MATCH,LOST,,
"Liverpool +0.5 @ 2.000
$20.00 Single",2019-04-29 22:43:35,20.0,0.0,-20.0,UCL,2.0,491.91,,ASIAN HANDICAP,PRE MATCH,LOST,Liverpool,
"Ajax @ 1.80
$20.00 Single",2019-04-30 13:38:51,20.0,0.0,-20.0,UCL,1.8,471.91,,FINAL RESULT,PRE MATCH,LOST,,
"Liverpool @ 2.05
$30.00 Single",2019-05-01 06:10:44,30.0,61.5,31.5,UCL,2.05,503.41,,FINAL RESULT,PRE MATCH,WIN,Liverpool,
"Liverpool @ 11.00
$10.00 Single",2019-05-01 15:03:25,10.0,0.0,-10.0,UCL,11.0,493.41,,FINAL RESULT,PRE MATCH,LOST,Liverpool,
"Beijing Guoan 0.0 @ 1.750
$40.00 Single",2019-05-03 22:42:58,40.0,70.0,30.0,CSL,1.75,523.41,,ASIAN HANDICAP,PRE MATCH,WIN,,
"Arsenal +0.5 @ 1.975
$20.00 Single",2019-05-05 14:17:18,20.0,39.5,19.5,UCL,1.975,542.91,,ASIAN HANDICAP,PRE MATCH,WIN,Arsenal,
"Liverpool 0.0 @ 1.930
$20.00 Single",2019-05-07 12:58:04,20.0,38.6,18.6,UCL,1.93,561.51,,ASIAN HANDICAP,PRE MATCH,WIN,Liverpool,
"Liverpool @ 19.00
$10.00 Single",2019-05-07 12:58:26,10.0,190.0,180.0,UCL,19.0,741.51,利物浦逆转巴萨，欧冠经典...,FINAL RESULT,PRE MATCH,WIN,Liverpool,Barcelona
"Ajax @ 2.25
$10.10 Single",2019-05-08 13:52:09,10.1,0.0,-10.1,UCL,2.25,731.41,,FINAL RESULT,PRE MATCH,LOST,,
"Arsenal +0.5 @ 2.070
$30.00 Single",2019-05-09 13:31:20,30.0,62.1,32.1,UCL,2.07,763.51,,ASIAN HANDICAP,PRE MATCH,WIN,Arsenal,
"Leeds @ 1.72

$21.60 Single",2019-05-15 12:15:28,21.6,0.0,-21.6,PL,1.72,741.91,,FINAL RESULT,PRE MATCH,LOST,Leeds United,
"Arsenal 0.0,+0.5 @ 1.800

$30.00 Single",2019-05-27 08:35:07,30.0,0.0,-30.0,UCL,1.8,711.91,,ASIAN HANDICAP,PRE MATCH,LOST,Arsenal,
"Arsenal +0.0 @ 2.05

$30.00 Single",2019-05-27 21:08:59,30.0,0.0,-30.0,UCL,2.05,681.91,,ASIAN HANDICAP,PRE MATCH,LOST,Arsenal,
"Arsenal 0.0,+0.5 @ 2.030

$20.00 Single",2019-05-29 06:33:18,20.0,0.0,-20.0,UCL,2.03,661.91,,ASIAN HANDICAP,PRE MATCH,LOST,Arsenal,
"Liverpool @ 1.90

$20.00 Single",2019-06-01 10:53:12,20.0,20.0,0.0,UCL,1.9,661.91,,FINAL RESULT,PRE MATCH,PUSH,Liverpool,
"Draw @ 4.33

$20.00 Single",2019-06-01 15:08:09,20.0,0.0,-20.0,UCL,4.33,641.91,,FINAL RESULT,PRE MATCH,LOST,,
"Holland 0.0,+0.5 @ 1.800

$100.00 Single",2019-06-07 09:14:14,100.0,0.0,-100.0,WWC,1.8,541.91,,ASIAN HANDICAP,PRE MATCH,LOST,,
"No @ 2.00

$30.00 Single",2019-06-07 09:16:18,30.0,60.0,30.0,WWC,2.0,571.91,,BTTS,PRE MATCH,WIN,,
"Holland @ 3.00

$20.00 Single",2019-06-07 09:28:12,20.0,0.0,-20.0,WWC,3.0,551.91,,FINAL RESULT,PRE MATCH,LOST,,
"Holland +1.0 @ 2.00

$20.00 Single",2019-06-09 13:09:45,20.0,0.0,-20.0,WWC,2.0,531.91,,ASIAN HANDICAP,PRE MATCH,LOST,,
"Holland @ 4.75

$10.00 Single",2019-06-09 14:47:56,10.0,0.0,-10.0,WWC,4.75,521.91,,FINAL RESULT,PRE MATCH,LOST,,
"Holland @ 21.00

$10.00 Single",2019-06-09 15:01:32,10.0,0.0,-10.0,WWC,21.0,511.91,,FINAL RESULT,PRE MATCH,LOST,,
"China PR Women @ 5.00

$20.00 Single",2019-06-17 08:22:13,20.0,0.0,-20.0,WWC,5.0,491.91,,FINAL RESULT,PRE MATCH,LOST,,
"France Women @ 3.60

$20.00 Single",2019-06-24 20:15:36,20.0,0.0,-20.0,WWC,3.6,471.91,,FINAL RESULT,PRE MATCH,LOST,,
"Germany Women @ 1.83

$30.00 Single",2019-06-24 20:15:43,30.0,0.0,-30.0,WWC,1.83,441.91,,FINAL RESULT,PRE MATCH,LOST,,
"Draw @ 3.75

$30.00 Single",2019-06-25 11:52:18,30.0,0.0,-30.0,WWC,3.75,411.91,,FINAL RESULT,PRE MATCH,LOST,,
"France Women 0.0,+0.5 @ 1.925

$20.00 Single",2019-06-28 08:38:03,20.0,0.0,-20.0,WWC,1.925,391.91,,ASIAN HANDICAP,PRE MATCH,LOST,,
"Germany Women @ 1.61

$50.00 Single",2019-06-29 07:29:08,50.0,0.0,-50.0,WWC,1.61,341.91,,FINAL RESULT,PRE MATCH,LOST,,
"Germany Women @ 10.00

$20.00 Single",2019-06-29 12:53:19,20.0,0.0,-20.0,WWC,10.0,321.91,,FINAL RESULT,PRE MATCH,LOST,,
"Holland Women +1.0 @ 1.900

$30.00 Single",2019-07-07 09:09:16,30.0,0.0,-30.0,WWC,1.9,291.91,,ASIAN HANDICAP,PRE MATCH,LOST,,
"Team Liquid @ 1.44

$20.00 Single",2019-08-17 05:38:42,20.0,28.89,8.89,TI,1.44,300.8,,FINAL RESULT,PRE MATCH,WIN,,
"Virtus Pro @ 2.62

$20.00 Single",2019-08-19 21:52:37,20.0,0.0,-20.0,TI,2.62,280.8,,FINAL RESULT,PRE MATCH,LOST,,
"PSG.LGD @ 1.44

$20.00 Single",2019-08-19 23:13:29,20.0,28.89,8.89,TI,1.44,289.69,,FINAL RESULT,PRE MATCH,WIN,Paris SG,
"Royal Never Give Up @ 1.80

$20.00 Single",2019-08-20 05:25:44,20.0,36.0,16.0,TI,1.8,305.69,,FINAL RESULT,PRE MATCH,WIN,,
"Fnatic @ 2.37

$20.00 Single",2019-08-20 07:06:59,20.0,0.0,-20.0,TI,2.37,285.69,,FINAL RESULT,PRE MATCH,LOST,,
"TNC @ 1.66

$23.33 Single",2019-08-21 06:46:27,23.33,0.0,-23.33,TI,1.66,262.36,,FINAL RESULT,PRE MATCH,LOST,,
"Team Liquid @ 1.66

$20.45 Single",2019-08-21 07:55:40,20.45,34.09,13.64,TI,1.66,276.0,,FINAL RESULT,PRE MATCH,WIN,,
"Newbee @ 1.83

$34.09 Single",2019-08-21 22:21:36,34.09,62.5,28.41,TI,1.83,304.41,,FINAL RESULT,PRE MATCH,WIN,,
"Team Secret @ 1.50

$22.50 Single",2019-08-22 03:34:11,22.5,33.75,11.25,TI,1.5,315.66,,FINAL RESULT,PRE MATCH,WIN,,
"Vici Gaming @ 2.10

$23.75 Single",2019-08-22 05:04:41,23.75,0.0,-23.75,TI,2.1,291.91,,FINAL RESULT,PRE MATCH,LOST,,
"Vici Gaming @ 2.00

$50.00 Single",2019-08-22 06:19:29,50.0,0.0,-50.0,TI,2.0,241.91,,FINAL RESULT,PRE MATCH,LOST,,
"OG @ 1.72

$30.00 Single",2019-08-22 08:52:01,30.0,51.82,21.82,TI,1.72,263.73,,FINAL RESULT,PRE MATCH,WIN,,
"OG @ 1.80

$21.82 Single",2019-08-22 10:06:48,21.82,39.28,17.46,TI,1.8,281.19,,FINAL RESULT,PRE MATCH,WIN,,
"Team Liquid @ 1.50

$100.00 Single",2019-08-22 22:34:44,100.0,150.0,50.0,TI,1.5,331.19,,FINAL RESULT,PRE MATCH,WIN,,
"Vici Gaming @ 2.10

$39.28 Single",2019-08-23 21:24:47,39.28,0.0,-39.28,TI,2.1,291.91,,FINAL RESULT,PRE MATCH,LOST,,
"Vici Gaming @ 1.83

$50.00 Single",2019-08-23 22:21:57,50.0,0.0,-50.0,TI,1.83,241.91,,FINAL RESULT,PRE MATCH,LOST,,
"Vici Gaming @ 1.83

$50.00 Single",2019-08-23 22:24:08,50.0,0.0,-50.0,TI,1.83,191.91,,FINAL RESULT,PRE MATCH,LOST,,
"OG @ 2.00

$50.00 Single",2019-08-23 23:31:30,50.0,0.0,-50.0,TI,2.0,141.91,,FINAL RESULT,PRE MATCH,LOST,,
"Shanghai Shenhua +2.5 @ 1.875

$20.00 Single",2019-11-30 23:41:58,20.0,0.0,-20.0,CSL,1.875,121.91,,ASIAN HANDICAP,PRE MATCH,LOST,Shanghai Shenhua,
"Man City @ 1.30

$100.00 Single",2019-12-05 10:33:58,100.0,0.0,-100.0,PL,1.3,21.91,,FINAL RESULT,PRE MATCH,LOST,Manchester City,
"Inter Milan -1.0 @ 1.980

$30.00 Single",2019-12-09 10:18:17,30.0,0.0,-30.0,UCL,1.98,-8.09,,ASIAN HANDICAP,PRE MATCH,LOST,Inter,
"Real Madrid @ 3.10

$20.00 Single",2019-12-18 11:42:29,20.0,62.0,42.0,La Liga,3.1,33.91,,ASIAN CORNER HANDICAP,PRE MATCH,WIN,Real Madrid,
"Real Madrid +2.0 @ 1.83

$30.00 Single",2019-12-18 11:42:39,30.0,30.0,0.0,La Liga,1.83,33.91,,ASIAN CORNER HANDICAP,PRE MATCH,PUSH,Real Madrid,
"Real Madrid @ 3.50

$20.00 Single",2019-12-18 14:31:04,20.0,0.0,-20.0,La Liga,3.5,13.91,,FINAL RESULT,LIVE,LOST,Real Madrid,
"Juventus @ 2.05

$22.00 Single",2019-12-21 21:22:23,22.0,0.0,-22.0,Serie A,2.05,-8.09,,FINAL RESULT,PRE MATCH,LOST,Juventus,
"Leicester +0.5 @ 1.940

$20.00 Single",2019-12-26 15:00:37,20.0,0.0,-20.0,PL,1.94,-28.09,,ASIAN HANDICAP,PRE MATCH,LOST,Leichester,
"Under 3.0 @ 2.030

$30.00 Single",2019-12-27 14:32:23,30.0,0.0,-30.0,PL,2.03,-58.09,,TOTAL GOAL,PRE MATCH,LOST,,
"Wolverhampton or Draw @ 2.75

$50.00 Single",2019-12-27 16:05:10,50.0,137.5,87.5,PL,2.75,29.41,,FINAL RESULT,LIVE,WIN,Wolverhampton,
"Wolverhampton or Draw @ 3.25

$50.00 Single",2019-12-27 16:21:02,50.0,162.5,112.5,PL,3.25,141.91,,FINAL RESULT,LIVE,WIN,Wolverhampton,
"Chelsea 0.0,-0.5 @ 2.070

$20.00 Single",2019-12-27 18:03:34,20.0,41.4,21.4,PL,2.07,163.31,,ASIAN HANDICAP,PRE MATCH,WIN,Chelsea,
"Over 2.5 @ 1.53

$20.00 Single",2019-12-28 21:38:07,20.0,30.67,10.67,PL,1.53,173.98,,TOTAL GOAL,PRE MATCH,WIN,,
"Over 2.5,3.0 @ 1.860

$20.00 Single",2019-12-29 08:55:09,20.0,28.6,8.6,PL,1.86,182.58,,TOTAL GOAL,PRE MATCH,WIN,,
"Chelsea or Draw @ 3.00

$40.00 Single",2019-12-29 10:28:50,40.0,120.0,80.0,PL,3.0,262.58,,FINAL RESULT,LIVE,WIN,Chelsea,
"Wolverhampton or Draw @ 3.40

$20.67 Single",2019-12-29 12:06:12,20.67,0.0,-20.67,PL,3.4,241.91,,FINAL RESULT,LIVE,LOST,Wolverhampton,
"Brescia +1.0 @ 1.920

$20.00 Single",2020-01-03 21:33:44,20.0,20.0,0.0,,1.92,241.91,,ASIAN HANDICAP,PRE MATCH,PUSH,,
"Southampton +1.0 @ 2.020

$20.00 Single",2020-01-03 21:36:40,20.0,40.4,20.4,,2.02,262.31,,ASIAN HANDICAP,PRE MATCH,WIN,Southampton,
"Real Madrid @ 1.83

$20.00 Single",2020-01-04 10:19:10,20.0,36.67,16.67,,1.83,278.98,,FINAL RESULT,PRE MATCH,WIN,Real Madrid,
"Espanyol @ 2.87

$16.67 Single",2020-01-04 15:39:50,16.67,0.0,-16.67,,2.87,262.31,,FINAL RESULT,PRE MATCH,LOST,Espanyol,
"Napoli 0.0,+0.5 @ 2.100

$40.00 Single",2020-01-10 06:57:53,40.0,40.0,0.0,,2.1,262.31,,ASIAN HANDICAP,PRE MATCH,PUSH,Napoli,
"Southampton +0.5,+1.0 @ 2.090

$20.00 Single",2020-01-11 00:06:33,20.0,41.8,21.8,,2.09,284.11,,ASIAN HANDICAP,PRE MATCH,WIN,Southampton,
"(0-0) Napoli +0.5 @ 1.900

$40.00 Single",2020-01-11 11:51:05,40.0,0.0,-40.0,,1.9,244.11,,ASIAN HANDICAP,LIVE,LOST,Napoli,
"Draw @ 6.50

$12.20 Single",2020-01-11 14:09:20,12.2,0.0,-12.2,,6.5,231.91,,FINAL RESULT,PRE MATCH,LOST,,
"Atalanta @ 6.00

$10.00 Single",2020-01-11 16:26:35,10.0,0.0,-10.0,,6.0,221.91,,FINAL RESULT,PRE MATCH,LOST,Atalanta,
"Real Madrid 0.0,-0.5 @ 2.070

$20.00 Single",2020-01-12 12:55:15,20.0,10.0,-10.0,,2.07,211.91,,ASIAN HANDICAP,PRE MATCH,LOST,Real Madrid,
"Roma or Draw @ 3.40

$30.00 Single",2020-01-12 16:17:38,30.0,0.0,-30.0,,3.4,181.91,,FINAL RESULT,LIVE,LOST,,
"Sampdoria +1.0,+1.5 @ 1.980

$40.00 Single",2020-01-14 17:14:28,40.0,0.0,-40.0,,1.98,141.91,,ASIAN HANDICAP,PRE MATCH,LOST,,
"Inter Milan @ 1.66

$60.00 Single",2020-01-19 10:26:04,60.0,0.0,-60.0,,1.66,81.91,,FINAL RESULT,PRE MATCH,LOST,Inter,
"Chelsea @ 1.72

$20.00 Single",2020-01-21 14:40:57,20.0,0.0,-20.0,,1.72,61.91,,FINAL RESULT,PRE MATCH,LOST,Chelsea,
"Chelsea @ 1.80

$180.00 Single",2020-01-21 15:25:29,180.0,0.0,-180.0,,1.8,-118.09,Chelsea v Arsenal(Fulltime Result),FINAL RESULT,PRE MATCH,LOST,Chelsea,Arsenal
"Valencia @ 1.72

$100.00 Single",2020-01-25 11:20:14,100.0,172.73,72.73,,1.72,-45.36,Valencia v Barcelona(Fulltime Result),FINAL RESULT,LIVE,WIN,Barcelona,Valencia
"Roma -1.0 @ 2.30

$22.73 Single",2020-01-26 11:17:33,22.73,52.28,29.55,,2.3,-15.81,,ASIAN HANDICAP,PRE MATCH,WIN,,
"Roma 0.0,+0.5 @ 1.820

$50.00 Single",2020-01-26 11:17:48,50.0,70.5,20.5,,1.82,4.69,,ASIAN HANDICAP,PRE MATCH,WIN,,
"Roma @ 2.75

$50.00 Single",2020-01-26 13:13:34,50.0,0.0,-50.0,,2.75,-45.31,,FINAL RESULT,PRE MATCH,LOST,,
"Real Madrid -0.5 @ 1.870

$22.78 Single",2020-02-01 09:22:39,22.78,42.6,19.82,,1.87,-25.49,,ASIAN HANDICAP,PRE MATCH,WIN,Real Madrid,
"Real Madrid @ 2.37

$160.00 Single",2020-02-01 11:05:36,160.0,321.54,161.54,La Liga,2.37,136.05,Real Madrid v Atletico Madrid(Fulltime Result),FINAL RESULT,PRE MATCH,WIN,Real Madrid,Atletico Madrid
"Burnley @ 4.00

$14.41 Single",2020-02-02 10:13:19,14.41,0.0,-14.41,,4.0,121.64,,FINAL RESULT,PRE MATCH,LOST,,
"Tottenham +1.0 @ 2.040

$19.73 Single",2020-02-02 11:07:27,19.73,40.25,20.52,,2.04,142.16,,ASIAN HANDICAP,PRE MATCH,WIN,Tottenham,
"Tottenham or Draw @ 2.10

$30.00 Single",2020-02-02 12:14:43,30.0,63.0,33.0,,2.1,175.16,,FINAL RESULT,LIVE,WIN,Tottenham,
"Inter Milan -0.5 @ 1.990

$33.25 Single",2020-02-07 20:15:04,33.25,66.17,32.92,,1.99,208.08,,ASIAN HANDICAP,PRE MATCH,WIN,Inter,
"Atalanta -0.5 @ 1.950

$20.00 Single",2020-02-08 08:27:42,20.0,39.0,19.0,,1.95,227.08,,ASIAN HANDICAP,PRE MATCH,WIN,Atalanta,
"Atalanta -1.0 @ 1.90

$20.00 Single",2020-02-08 08:33:36,20.0,0.0,-20.0,,1.9,207.08,,ASIAN HANDICAP,PRE MATCH,LOST,Atalanta,
"Inter Milan -0.5 @ 2.000

$39.00 Single",2020-02-09 09:36:34,39.0,78.0,39.0,,2.0,246.08,,ASIAN HANDICAP,PRE MATCH,WIN,Inter,
"Parma @ 19.00

$10.00 Single",2020-02-09 13:08:29,10.0,0.0,-10.0,,19.0,236.08,,FINAL RESULT,PRE MATCH,LOST,,
"Inter Milan -0.5 @ 2.125

$20.00 Single",2020-02-09 14:04:06,20.0,42.5,22.5,,2.125,258.58,,ASIAN HANDICAP,PRE MATCH,WIN,Inter,
"Inter Milan @ 2.50

$20.00 Single",2020-02-09 16:01:54,20.0,50.0,30.0,,2.5,288.58,,FINAL RESULT,PRE MATCH,WIN,Inter,
"Inter Milan -0.5 @ 2.025

$16.67 Single",2020-02-12 14:11:44,16.67,0.0,-16.67,,2.025,271.91,,ASIAN HANDICAP,PRE MATCH,LOST,Inter,
"Getafe -1.0 @ 2.100

$20.00 Single",2020-02-15 09:38:08,20.0,0.0,-20.0,,2.1,251.91,,ASIAN HANDICAP,PRE MATCH,LOST,Getafe,
"Inter Milan 0.0,+0.5 @ 1.820

$80.00 Single",2020-02-16 13:50:51,80.0,80.0,0.0,,1.82,251.91,Lazio v Inter Milan(Asian Handicap),ASIAN HANDICAP,PRE MATCH,PUSH,Inter,Lazio
"Inter Milan @ 2.90

$30.00 Single",2020-02-16 13:58:10,30.0,0.0,-30.0,,2.9,221.91,Lazio v Inter Milan(Asian Handicap),FINAL RESULT,PRE MATCH,LOST,Inter,Lazio
"Inter Milan 0.0 @ 2.125

$50.00 Single",2020-02-16 14:17:21,50.0,0.0,-50.0,,2.125,171.91,Lazio v Inter Milan(Asian Handicap),ASIAN HANDICAP,PRE MATCH,LOST,Inter,Lazio
"Inter Milan 0.0 @ 2.125

$100.00 Single",2020-02-16 14:18:06,100.0,0.0,-100.0,Serie A,2.125,71.91,Lazio v Inter Milan(Asian Handicap),ASIAN HANDICAP,PRE MATCH,LOST,Inter,Lazio
"Inter Milan @ 3.40

$50.00 Single",2020-02-16 15:58:29,50.0,0.0,-50.0,,3.4,21.91,Lazio v Inter Milan(Asian Handicap),FINAL RESULT,PRE MATCH,LOST,Inter,Lazio
"Inter Milan @ 26.00

$20.00 Single",2020-02-16 16:18:59,20.0,0.0,-20.0,,26.0,1.91,Lazio v Inter Milan(Asian Handicap),FINAL RESULT,LIVE,LOST,Inter,Lazio
"Liverpool @ 2.25

$30.00 Single",2020-02-18 07:57:23,30.0,0.0,-30.0,,2.25,-28.09,,FINAL RESULT,PRE MATCH,LOST,Liverpool,
"Liverpool 0.0,-0.5 @ 2.000

$100.00 Single",2020-02-18 08:12:48,100.0,0.0,-100.0,UCL,2.0,-128.09,Atletico Madrid v Liverpool(Asian Handicap),ASIAN HANDICAP,PRE MATCH,LOST,Liverpool,Atletico Madrid
"Liverpool @ 9.50

$20.00 Single",2020-02-18 16:13:46,20.0,0.0,-20.0,,9.5,-148.09,,FINAL RESULT,PRE MATCH,LOST,Liverpool,
"Atalanta to score 3rd goal @ 1.83

$30.00 Single",2020-02-19 16:07:42,30.0,55.0,25.0,,1.83,-123.09,,TEAM TO SCORE,LIVE,WIN,Atalanta,
"Atalanta to score 5th goal @ 2.25

$15.00 Single",2020-02-19 16:24:09,15.0,0.0,-15.0,,2.25,-138.09,,TEAM TO SCORE,LIVE,LOST,Atalanta,
"Draw @ 7.00

$10.00 Single",2020-02-19 16:44:45,10.0,0.0,-10.0,,7.0,-148.09,,FINAL RESULT,PRE MATCH,LOST,,
"Man City -1.0 @ 2.010

$30.00 Single",2020-02-22 12:04:25,30.0,30.0,0.0,UCL,2.01,-148.09,"Man City vs Real Madrid
热苏斯超神，看准了就是吃",ASIAN HANDICAP,PRE MATCH,PUSH,Real Madrid,Manchester City
"Napoli -1.0 @ 2.75

$180.00 Single",2020-02-25 09:24:13,180.0,180.0,0.0,UCL,2.75,-148.09,Napoli v Barcelona(Corner Handicap),ASIAN CORNER HANDICAP,PRE MATCH,CASH_OUT,Barcelona,Napoli
"Napoli -1.0 @ 2.75

$80.00 Single",2020-02-25 14:01:07,80.0,0.0,-80.0,UCL,2.75,-228.09,Napoli v Barcelona(Corner Handicap),ASIAN CORNER HANDICAP,PRE MATCH,LOST,Barcelona,Napoli
"Man City @ 2.30

$100.00 Single",2020-02-26 14:12:57,100.0,100.0,0.0,,2.3,-228.09,,FINAL RESULT,PRE MATCH,PUSH,Manchester City,
"Man City -1.0 @ 1.900

$50.00 Single",2020-02-26 14:33:31,50.0,95.0,45.0,UCL,1.9,-183.09,"Man City vs Real Madrid
热苏斯超神，看准了就是吃",ASIAN HANDICAP,PRE MATCH,WIN,Real Madrid,Manchester City
"Man City 0.0,-0.5 @ 2.020

$50.00 Single",2020-02-26 14:34:03,50.0,101.0,51.0,UCL,2.02,-132.09,"Man City vs Real Madrid
热苏斯超神，看准了就是吃",ASIAN HANDICAP,PRE MATCH,WIN,Real Madrid,Manchester City
"Man City @ 2.60

$30.00 Single",2020-02-26 16:10:58,30.0,78.0,48.0,UCL,2.6,-84.09,"Man City vs Real Madrid
热苏斯超神，看准了就是吃",FINAL RESULT,PRE MATCH,WIN,Real Madrid,Manchester City
"Man City @ 8.00

$70.00 Single",2020-02-26 16:19:19,70.0,560.0,490.0,UCL,8.0,405.91,"Man City vs Real Madrid
热苏斯超神，看准了就是吃",FINAL RESULT,LIVE,WIN,Real Madrid,Manchester City
"Ludogorets Razgrad +1.0,+1.5 @ 2.040

$34.00 Single",2020-02-27 14:18:24,34.0,51.68,17.68,,2.04,423.59,,ASIAN HANDICAP,PRE MATCH,WIN,,
"Bologna +1.0 @ 1.970

$21.68 Single",2020-02-29 08:19:21,21.68,0.0,-21.68,,1.97,401.91,,ASIAN HANDICAP,PRE MATCH,LOST,,
"Bologna to score 3rd goal @ 2.50

$30.00 Single",2020-02-29 10:19:38,30.0,0.0,-30.0,,2.5,371.91,,TEAM TO SCORE,LIVE,LOST,,
"Real Madrid 0.0,-0.5 @ 2.010

$50.00 Single",2020-03-01 14:08:38,50.0,100.5,50.5,,2.01,422.41,"Real Madrid vs Barc
吃!",ASIAN HANDICAP,PRE MATCH,WIN,Real Madrid,Barcelona
"Real Madrid 0.0,-0.5 @ 2.010
$60.00 Single
",2020-03-01 14:10:03,60.0,120.6,60.6,,2.01,483.01,"Real Madrid vs Barc
吃!",ASIAN HANDICAP,PRE MATCH,WIN,Real Madrid,Barcelona
"Real Madrid @ 2.87

$30.00 Single",2020-03-01 16:15:54,30.0,86.25,56.25,,2.87,539.26,"Real Madrid vs Barc
吃!",FINAL RESULT,PRE MATCH,WIN,Real Madrid,Barcelona
"Man City to score 2nd goal @ 1.83

$27.35 Single",2020-03-08 12:47:50,27.35,0.0,-27.35,,1.83,511.91,,TEAM TO SCORE,LIVE,LOST,Manchester City,
"Inter Milan 0.0,+0.5 @ 2.040

$20.00 Single",2020-03-08 14:10:27,20.0,0.0,-20.0,,2.04,491.91,,ASIAN HANDICAP,PRE MATCH,LOST,Inter,
"Inter Milan to score 2nd goal @ 2.62

$20.00 Single",2020-03-08 15:56:17,20.0,0.0,-20.0,,2.62,471.91,,TEAM TO SCORE,LIVE,LOST,Inter,
"Tottenham @ 6.00

$20.00 Single",2020-03-10 14:58:46,20.0,0.0,-20.0,,6.0,451.91,,FINAL RESULT,PRE MATCH,LOST,Tottenham,
"Tottenham @ 51.00

$10.00 Single",2020-03-10 16:08:22,10.0,0.0,-10.0,,51.0,441.91,,FINAL RESULT,PRE MATCH,LOST,Tottenham,
"Over 2.5 @ 1.990

$30.00 Single",2020-03-11 14:54:33,30.0,0.0,-30.0,,1.99,411.91,,TOTAL GOAL,PRE MATCH,LOST,,
"Over 2.5 @ 1.990

$20.00 Single",2020-03-11 14:55:16,20.0,0.0,-20.0,,1.99,391.91,,TOTAL GOAL,PRE MATCH,LOST,,
"Over 2.5 @ 1.990

$20.00 Single",2020-03-11 14:57:22,20.0,0.0,-20.0,,1.99,371.91,,TOTAL GOAL,PRE MATCH,LOST,,
"Atletico Madrid to score 2nd goal @ 8.50

$20.00 Single",2020-03-11 16:31:55,20.0,0.0,-20.0,,8.5,351.91,,TEAM TO SCORE,LIVE,LOST,Atletico Madrid,
"Sevilla @ 5.50

$20.00 Single",2020-06-19 16:33:03,20.0,0.0,-20.0,La Liga,5.5,331.91,,FINAL RESULT,PRE MATCH,LOST,Sevilla,
"(0-0) Real Madrid -0.5,-1.0 @ 1.930

$60.00 Single",2020-06-21 15:04:23,60.0,106.98,46.98,La Liga,1.93,378.89,,ASIAN HANDICAP,LIVE,WIN,Real Madrid,
"Atalanta @ 2.10

$26.98 Single",2020-06-23 05:01:31,26.98,56.66,29.68,Serie A,2.1,408.57,"Atalanta vs Lazio
拉齐奥复赛第一场，看出完全
是XJBT, 果然被逆转",FINAL RESULT,PRE MATCH,WIN,Lazio,Atalanta
"Atalanta 0.0,-0.5 @ 2.010

$30.00 Single",2020-06-24 14:42:41,30.0,60.3,30.3,Serie A,2.01,438.87,"Atalanta vs Lazio
拉齐奥复赛第一场，看出完全
是XJBT, 果然被逆转",ASIAN HANDICAP,PRE MATCH,WIN,Lazio,Atalanta
"Atalanta @ 4.75

$20.00 Single",2020-06-24 15:59:26,20.0,95.0,75.0,Serie A,4.75,513.87,"Atalanta vs Lazio
拉齐奥复赛第一场，看出完全
是XJBT, 果然被逆转",FINAL RESULT,PRE MATCH,WIN,Lazio,Atalanta
"Man City @ 2.10

$21.96 Single",2020-06-25 15:28:26,21.96,0.0,-21.96,PL,2.1,491.91,,FINAL RESULT,PRE MATCH,LOST,Manchester City,
"Real Madrid -1.0 @ 1.850

$50.00 Single",2020-06-28 11:24:37,50.0,50.0,0.0,La Liga,1.85,491.91,,ASIAN HANDICAP,PRE MATCH,PUSH,Real Madrid,
"Real Madrid -1.0 @ 1.860

$70.00 Single",2020-06-28 11:26:18,70.0,70.0,0.0,La Liga,1.86,491.91,,ASIAN HANDICAP,PRE MATCH,PUSH,Real Madrid,
"Atletico Madrid +0.5 @ 2.030

$100.00 Single",2020-06-29 18:59:25,100.0,94.42,-5.58,La Liga,2.03,486.33,"马竞 vs Barcelona
巴萨本赛季送钱童子，看准了
就是是吃",ASIAN HANDICAP,PRE MATCH,CASH_OUT,Barcelona,Atletico Madrid
"Atletico Madrid +0.5,+1.0 @ 1.950

$114.42 Single",2020-06-30 12:05:07,114.42,223.12,108.7,La Liga,1.95,595.03,"马竞 vs Barcelona
巴萨本赛季送钱童子，看准了
就是是吃",ASIAN HANDICAP,PRE MATCH,WIN,Barcelona,Atletico Madrid
"Draw @ 5.50

$20.00 Single",2020-06-30 16:14:54,20.0,110.0,90.0,La Liga,5.5,685.03,,FINAL RESULT,LIVE,WIN,,
"Atletico Madrid to score 5th goal @ 6.00

$10.00 Single",2020-06-30 16:41:17,10.0,0.0,-10.0,La Liga,6.0,675.03,,TEAM TO SCORE,LIVE,LOST,Atletico Madrid,
"Man City to score 2nd goal @ 1.95

$23.12 Single",2020-07-02 14:45:49,23.12,45.14,22.02,PL,1.95,697.05,"Man City vs Liverpool
利物浦已夺冠，欧冠已被淘汰
战意决定一切
尤文意甲夺冠后最后几轮也是拉胯",TEAM TO SCORE,LIVE,WIN,Liverpool,Manchester City
"Real Madrid @ 1.80

$15.14 Single",2020-07-02 15:22:01,15.14,27.26,12.12,La Liga,1.8,709.17,,FINAL RESULT,LIVE,WIN,Real Madrid,
"Real Madrid @ 2.40

$20.00 Single",2020-07-02 16:23:30,20.0,48.0,28.0,La Liga,2.4,737.17,,FINAL RESULT,LIVE,WIN,Real Madrid,
"Juventus 0.0,-0.5 @ 2.030

$25.26 Single",2020-07-07 15:03:28,25.26,0.0,-25.26,Serie A,2.03,711.91,"Juventus vs Milan
米兰4球逆转，坑爹",ASIAN HANDICAP,PRE MATCH,LOST,Juventus,AC Milan
"Napoli 0.0,-0.5 @ 1.870

$40.00 Single",2020-07-11 10:00:56,40.0,20.0,-20.0,Serie A,1.87,691.91,"Napoli vs AC Milan
米兰又是坑爹点球扳平. 幸好滚球提前cash out, 策略正确",ASIAN HANDICAP,PRE MATCH,LOST,Napoli,AC Milan
"Atalanta 0.0,+0.5 @ 2.040

$50.00 Single",2020-07-11 14:38:03,50.0,76.0,26.0,Serie A,2.04,717.91,"Atalanta vs Juventus
尤文两个点球坑爹",ASIAN HANDICAP,PRE MATCH,WIN,Juventus,Atalanta
"Atalanta @ 5.00

$10.00 Single",2020-07-11 16:16:23,10.0,0.0,-10.0,Serie A,5.0,707.91,"Atalanta vs Juventus
尤文两个点球坑爹",FINAL RESULT,LIVE,LOST,Juventus,Atalanta
"Napoli @ 2.20

$30.00 Single",2020-07-12 14:49:54,30.0,0.0,-30.0,Serie A,2.2,677.91,"Napoli vs AC Milan
米兰又是坑爹点球扳平. 幸好滚球提前cash out, 策略正确",FINAL RESULT,PRE MATCH,LOST,Napoli,AC Milan
"Napoli @ 3.75

$36.00 Single",2020-07-12 15:09:05,36.0,99.0,63.0,Serie A,3.75,740.91,"Napoli vs AC Milan
米兰又是坑爹点球扳平. 幸好滚球提前cash out, 策略正确",FINAL RESULT,LIVE,WIN,Napoli,AC Milan
"Southampton @ 34.00

$9.00 Single",2020-07-13 15:12:29,9.0,0.0,-9.0,PL,34.0,731.91,,FINAL RESULT,PRE MATCH,LOST,Southampton,
"Man City @ 4.75

$20.00 Single",2020-07-18 15:10:36,20.0,0.0,-20.0,PL,4.75,711.91,,FINAL RESULT,PRE MATCH,LOST,Manchester City,
"Bologna to score 4th goal @ 3.40

$40.00 Single",2020-07-18 15:32:01,40.0,0.0,-40.0,Serie A,3.4,671.91,,TEAM TO SCORE,LIVE,LOST,,
"Juventus to score 3rd goal @ 2.40

$30.00 Single",2020-07-20 16:18:56,30.0,0.0,-30.0,Serie A,2.4,641.91,,TEAM TO SCORE,LIVE,LOST,Juventus,
"Sassuolo +0.5,+1.0 @ 1.940

$20.00 Single",2020-07-21 14:40:49,20.0,10.0,-10.0,Serie A,1.94,631.91,,ASIAN HANDICAP,PRE MATCH,LOST,,
"Sassuolo @ 4.33

$20.00 Single",2020-07-21 15:30:12,20.0,0.0,-20.0,Serie A,4.33,611.91,,FINAL RESULT,PRE MATCH,LOST,,
"Atalanta 0.0,-0.5 @ 1.980

$40.00 Single",2020-07-23 14:25:03,40.0,20.0,-20.0,Serie A,1.98,591.91,,ASIAN HANDICAP,PRE MATCH,LOST,Atalanta,
"Atalanta -1.0 @ 2.37

$50.00 Single",2020-07-23 14:25:54,50.0,118.75,68.75,Serie A,2.37,660.66,"
AC Milan v Atalanta(Corner Handicap)
角球大数据",ASIAN CORNER HANDICAP,PRE MATCH,WIN,Atalanta,
"Atalanta @ 2.25

$30.00 Single",2020-07-24 15:23:37,30.0,0.0,-30.0,Serie A,2.25,630.66,,FINAL RESULT,PRE MATCH,LOST,Atalanta,
"Atalanta @ 2.75

$20.00 Single",2020-07-24 16:01:23,20.0,0.0,-20.0,Serie A,2.75,610.66,,FINAL RESULT,PRE MATCH,LOST,Atalanta,
"Atalanta @ 2.87

$50.00 Single",2020-07-24 16:05:28,50.0,0.0,-50.0,Serie A,2.87,560.66,,FINAL RESULT,PRE MATCH,LOST,Atalanta,
"No @ 1.80

$38.75 Single",2020-07-26 09:49:19,38.75,69.75,31.0,PL,1.8,591.66,"Chelsea v Wolverhampton(Both Teams to Score)
英超最后一轮, 切尔西争欧冠席位, 打平即可.谨慎为上",BTTS,PRE MATCH,WIN,Chelsea,Wolverhampton
"Inter Milan to score 2nd goal @ 2.50

$29.75 Single",2020-07-28 16:12:06,29.75,74.38,44.63,Serie A,2.5,636.29,,TEAM TO SCORE,LIVE,WIN,Inter,
"Atalanta to score 3rd goal @ 2.75

$24.38 Single",2020-08-01 15:13:47,24.38,0.0,-24.38,Serie A,2.75,611.91,,TEAM TO SCORE,LIVE,LOST,Atalanta,
"Getafe @ 3.20

$50.00 Single",2020-08-04 12:32:35,50.0,160.0,110.0,UCL,3.2,721.91,"Getafe vs Inter
角球大数据精准命中 (Cross + Corner)",ASIAN CORNER HANDICAP,PRE MATCH,WIN,Inter,Getafe
"Getafe to score 2nd goal @ 3.60

$20.00 Single",2020-08-05 15:16:26,20.0,0.0,-20.0,UCL,3.6,701.91,"Getafe vs Inter

本来应该命中的，可惜点球发丢了",TEAM TO SCORE,LIVE,LOST,Inter,Getafe
"Getafe to score 2nd goal @ 4.33

$20.00 Single",2020-08-05 15:28:53,20.0,0.0,-20.0,UCL,4.33,681.91,"Getafe vs Inter

本来应该命中的，可惜点球发丢了",TEAM TO SCORE,LIVE,LOST,Inter,Getafe
"Lyon +1.0 @ 1.970

$60.00 Single",2020-08-07 13:02:18,60.0,60.0,0.0,UCL,1.97,681.91,"Lyon vs Juventus
欧冠16进8， Lyon半年没正式比赛了
尤文依然拉胯, 可见意甲的强度之低",ASIAN HANDICAP,PRE MATCH,PUSH,Juventus,
"Man City to score 4th goal @ 2.10

$20.00 Single",2020-08-07 15:32:40,20.0,0.0,-20.0,UCL,2.1,661.91,"Man City vs Real Madrid
欧冠16进8， 拉莫斯停赛。瓦拉内2次低级失误。
强调中卫组合稳定性
偶联Roma vs Sevilla也验证了这一点(Smalling缺阵)",TEAM TO SCORE,LIVE,LOST,Real Madrid,Manchester City
"Napoli +1.0 @ 2.000

$40.00 Single",2020-08-08 13:59:47,40.0,80.0,40.0,,2.0,701.91,"Barcelona v Napoli
这个角球还是很稳的...",ASIAN CORNER HANDICAP,PRE MATCH,WIN,Barcelona,Napoli
"Napoli to score 5th goal @ 3.75

$20.00 Single",2020-08-08 15:36:34,20.0,0.0,-20.0,,3.75,681.91,,TEAM TO SCORE,LIVE,LOST,Napoli,
"Man City -1.5 @ 1.930

$30.00 Single",2020-08-08 19:15:12,30.0,31.59,1.59,,1.93,683.5,"Man City v Lyon(Asian Handicap)
这场感觉到爆冷风险提前cash out, 事后证明是正确的",ASIAN HANDICAP,PRE MATCH,CASH_OUT,Manchester City,
"Bayern Munich @ 1.95

$30.00 Single",2020-08-10 10:04:39,30.0,30.0,0.0,,1.95,683.5,"拜仁 vs 巴萨
看了一赛季巴萨，结果并不意外，最稳的一场",FINAL RESULT,PRE MATCH,CASH_OUT,Bayern Munich,Barcelona
"Bayern Munich -0.5 @ 2.020

$50.00 Single",2020-08-10 10:05:14,50.0,101.0,51.0,UCL,2.02,734.5,"拜仁 vs 巴萨
看了一赛季巴萨，结果并不意外，最稳的一场",ASIAN HANDICAP,PRE MATCH,WIN,Bayern Munich,Barcelona
"Bayern Munich -0.5 @ 2.020

$50.00 Single",2020-08-10 10:05:41,50.0,101.0,51.0,UCL,2.02,785.5,拜仁 vs 巴萨,ASIAN HANDICAP,PRE MATCH,WIN,Bayern Munich,Barcelona
"Over 2.0 @ 2.000

$30.00 Single",2020-08-11 10:29:22,30.0,0.0,-30.0,UCL,2.0,755.5,Wolverhampton v Sevilla(Goal Line),TOTAL GOAL,PRE MATCH,LOST,Sevilla,Wolverhampton
"Over 2.0 @ 2.100

$20.00 Single",2020-08-11 13:28:07,20.0,0.0,-20.0,UCL,2.1,735.5,"Wolverhampton v Sevilla(Goal Line)
这个参考两队数据应该可以看出端倪:
狼队龟缩，火力不强",TOTAL GOAL,PRE MATCH,LOST,Sevilla,Wolverhampton
"Over 1.0,1.5 @ 2.150

$38.00 Single",2020-08-12 14:00:08,38.0,41.24,3.24,,2.15,738.74,"Atalanta vs Paris
半场大小球",TOTAL GOAL,PRE MATCH,CASH_OUT,Paris SG,Atalanta
"Over 1.0,1.5 @ 2.150

$12.00 Single",2020-08-12 14:00:22,12.0,6.0,-6.0,UCL,2.15,732.74,,TOTAL GOAL,PRE MATCH,LOST,,
"Atalanta to score 2nd goal @ 3.00

$27.24 Single",2020-08-12 15:07:02,27.24,0.0,-27.24,UCL,3.0,705.5,,TEAM TO SCORE,LIVE,LOST,Atalanta,
"Atalanta to score 2nd goal @ 4.33

$20.00 Single",2020-08-12 15:33:15,20.0,0.0,-20.0,UCL,4.33,685.5,,TEAM TO SCORE,LIVE,LOST,Atalanta,
"Atletico Madrid to score 3rd goal @ 4.33

$20.00 Single",2020-08-13 15:38:58,20.0,0.0,-20.0,UCL,4.33,665.5,,TEAM TO SCORE,LIVE,LOST,Atletico Madrid,
"Atletico Madrid to score 3rd goal @ 4.33

$10.00 Single",2020-08-13 15:39:30,10.0,0.0,-10.0,UCL,4.33,655.5,,TEAM TO SCORE,LIVE,LOST,Atletico Madrid,
"Bayern Munich -0.5 @ 2.000

$100.00 Single",2020-08-13 22:39:11,100.0,200.0,100.0,UCL,2.0,755.5,"拜仁 vs 巴萨
看了一赛季巴萨，结果并不意外，最稳的一场",ASIAN HANDICAP,PRE MATCH,WIN,Bayern Munich,Barcelona
"Bayern Munich to score 8th goal @ 2.10

$50.00 Single",2020-08-14 15:29:43,50.0,105.0,55.0,UCL,2.1,810.5,"拜仁 vs 巴萨
最后莱万还没进，所以来了第8个...",TEAM TO SCORE,LIVE,WIN,Bayern Munich,Barcelona
"Sevilla 0.0 @ 2.000

$57.00 Single",2020-08-15 09:32:34,57.0,0.0,-57.0,,2.0,753.5,Sevilla v Man Utd(Asian Handicap Corners),ASIAN CORNER HANDICAP,PRE MATCH,LOST,Manchester United,Sevilla
"Man City @ 3.75

$31.59 Single",2020-08-15 15:18:17,31.59,0.0,-31.59,,3.75,721.91,,FINAL RESULT,PRE MATCH,LOST,Manchester City,
"Beijing Guoan to score 6th goal @ 1.80

$100.00 Single",2020-08-16 06:27:34,100.0,0.0,-100.0,CSL,1.8,621.91,中超赛季处子秀，卒,TEAM TO SCORE,LIVE,LOST,,
"Man Utd @ 2.40

$200.00 Single",2020-08-16 15:21:09,200.0,0.0,-200.0,UCL,2.4,421.91,被曼城搞了心态，崩,FINAL RESULT,PRE MATCH,LOST,Manchester City,
"Inter Milan to score 3rd goal @ 2.20

$200.00 Single",2020-08-17 15:23:00,200.0,440.0,240.0,UCL,2.2,661.91,"Inter Milan v Shakhtar Donetsk
曼城把心态搞崩了，孤注一掷. 
根据矿工之前打亚特兰大的拉胯后防最后崩盘判定其还会继续丢球，最后果然再丢三个",TEAM TO SCORE,LIVE,WIN,Inter,AC Milan
"Draw @ 4.00

$40.00 Single",2020-08-18 11:09:41,40.0,0.0,-40.0,UCL,4.0,621.91,"Paris vs LPZ
不看好巴黎，博个平局",FINAL RESULT,PRE MATCH,LOST,Paris SG,RB Leipzig
"Bayern Munich -0.5 @ 1.950

$200.00 Single",2020-08-19 16:19:02,200.0,200.0,0.0,UCL,1.95,621.91,,ASIAN HANDICAP,PRE MATCH,PUSH,Bayern Munich,
"Bayern Munich -0.5 @ 1.950

$100.00 Single",2020-08-19 16:20:16,100.0,195.0,95.0,UCL,1.95,716.91,"欧冠决赛,赛季的完美句号
巴黎毫无胜算，决赛资金量大, 小注规避风险",ASIAN HANDICAP,PRE MATCH,WIN,Bayern Munich,
"Sevilla 0.0,+0.5 @ 1.925

$100.00 Single",2020-08-21 12:32:47,100.0,192.5,92.5,UCL,1.925,809.41,"欧联决赛, Sevilla vs Inter
国米赛前赔率显示为优势. 
一个赛季意甲没白看, 拉胯联赛，孔蒂垃圾",ASIAN HANDICAP,PRE MATCH,WIN,Inter,Sevilla
"Sevilla to score 5th goal @ 4.33

$50.00 Single",2020-08-21 15:28:04,50.0,216.67,166.67,UCL,4.33,976.08,"欧联决赛, Sevilla vs Inter
国米赛前赔率显示为优势. 
一个赛季意甲没白看, 拉胯联赛，孔蒂垃圾",TEAM TO SCORE,LIVE,WIN,Inter,Sevilla
"Bayern Munich -0.5 @ 2.070

$79.17 Single
",2020-08-21 19:23:25,79.17,143.89,64.72,UCL,2.07,1040.8,,ASIAN HANDICAP,PRE MATCH,WIN,Bayern Munich,
"Bayern Munich -2.0 @ 1.975

$50.00 Single",2020-08-23 13:11:01,50.0,0.0,-50.0,UCL,1.975,990.8,欧冠决赛，这个角球没打出比较意外,ASIAN CORNER HANDICAP,PRE MATCH,LOST,Bayern Munich,
"Shandong Luneng -0.5 @ 1.875

$38.89 Single",2020-08-29 06:58:45,38.89,0.0,-38.89,,1.875,951.91,,ASIAN HANDICAP,PRE MATCH,LOST,,
"Leeds @ 10.00

$50.00 Single",2020-09-06 09:39:47,50.0,0.0,-50.0,PL,10.0,901.91,"Leeds vs Liverpool
庆祝Leeds联重返英超, 情怀一注只为支持贝尔萨",FINAL RESULT,PRE MATCH,LOST,Leeds United,Liverpool
"Everton @ 4.75

$20.00 Single",2020-09-13 11:34:57,20.0,95.0,75.0,PL,4.75,976.91,Tottenham v Everton(Fulltime Result),FINAL RESULT,PRE MATCH,WIN,Tottenham,Everton
"Dalian Pro @ 1.83

$25.00 Single",2020-09-14 07:12:54,25.0,0.0,-25.0,,1.83,951.91,,FINAL RESULT,PRE MATCH,LOST,,
"Liverpool 0.0,-0.5 @ 1.980

$50.00 Single",2020-09-20 06:31:47,50.0,99.0,49.0,PL,1.98,1000.91,Chelsea v Liverpool,ASIAN HANDICAP,PRE MATCH,WIN,Liverpool,Chelsea
"Liverpool @ 2.20

$50.00 Single",2020-09-20 11:08:35,50.0,110.0,60.0,PL,2.2,1060.91,Chelsea v Liverpool(Fulltime Result),FINAL RESULT,PRE MATCH,WIN,Liverpool,Chelsea
"Man City -1.0 @ 1.870

$29.00 Single",2020-09-21 14:11:12,29.0,54.23,25.23,,1.87,1086.14,,ASIAN HANDICAP,PRE MATCH,WIN,Manchester City,
"Atalanta 0.0 @ 1.950

$50.00 Single",2020-09-29 08:36:12,50.0,97.5,47.5,,1.95,1133.64,,ASIAN HANDICAP,PRE MATCH,WIN,Atalanta,
"Leeds +1.5 @ 1.940

$34.23 Single",2020-09-30 05:26:56,34.23,66.41,32.18,,1.94,1165.82,,ASIAN HANDICAP,PRE MATCH,WIN,Leeds United,
"Borussia Dortmund to score 5th goal @ 3.40

$50.00 Single",2020-09-30 14:52:58,50.0,0.0,-50.0,,3.4,1115.82,,TEAM TO SCORE,LIVE,LOST,Dortmund,
"Leeds @ 21.00

$17.50 Single",2020-10-03 12:36:23,17.5,0.0,-17.5,,21.0,1098.32,,FINAL RESULT,PRE MATCH,LOST,Leeds United,
"Borussia Dortmund 0.0,-0.5 @ 1.980

$96.41 Single",2020-10-07 07:11:42,96.41,0.0,-96.41,UCL,1.98,1001.91,"Lazio vs Dortmund, 大崩盘的第二场
提前投注, 以当时的眼光来看，这赔率真TMD就是白送",ASIAN HANDICAP,PRE MATCH,LOST,Lazio,Dortmund
"Beijing Guoan @ 3.00

$20.00 Single",2020-10-17 04:00:31,20.0,0.0,-20.0,,3.0,981.91,,FINAL RESULT,PRE MATCH,LOST,,
"Inter Milan -0.5 @ 2.080

$80.00 Single",2020-10-17 10:28:29,80.0,0.0,-80.0,,2.08,901.91,"Inter vs AC Milan
有三支球队我是长期做空的: 拉齐奥, 热刺(穆里尼奥), 米兰(伊布). 坚决做空米兰因为伊布的球风和跑动能力. 结果米兰本赛季意甲10轮后排名第一，脸都给我打肿了
恰好碰上我在意甲无脑做多的国际米兰(英超班子, 劳塔罗). 孔蒂真心是坑爹, 本赛季可能要粉转黑",ASIAN HANDICAP,PRE MATCH,LOST,Inter,AC Milan
"Inter Milan @ 3.40

$50.00 Single",2020-10-17 11:36:00,50.0,0.0,-50.0,,3.4,851.91,"Inter vs AC Milan
有三支球队我是长期做空的: 拉齐奥, 热刺(穆里尼奥), 米兰(伊布). 坚决做空米兰因为伊布的球风和跑动能力. 结果米兰本赛季意甲10轮后排名第一，脸都给我打肿了
恰好碰上我在意甲无脑做多的国际米兰(英超班子, 劳塔罗). 孔蒂真心是坑爹, 本赛季可能要粉转黑",FINAL RESULT,LIVE,LOST,Inter,AC Milan
"Shanghai SIPG -1.0 @ 1.800

$150.00 Single",2020-10-17 18:58:53,150.0,0.0,-150.0,CSL,1.8,701.91,"上港vs申花, 大崩盘的开始
投注依据：中超靠外援, 上港有新晋英超大腿外援，申花只有双外援, 上港常规赛数据全面占优
主要问题: 没认真看过两队的比赛, 完全不了解上港队内的一些问题(事后才知道有外援续约，降薪和态度问题)",ASIAN HANDICAP,PRE MATCH,LOST,Shanghai Shenhua,
"Shanghai SIPG -1.0 @ 1.975

$100.00 Single",2020-10-18 06:21:23,100.0,0.0,-100.0,CSL,1.975,601.91,"上港vs申花, 大崩盘的开始",ASIAN HANDICAP,PRE MATCH,LOST,Shanghai Shenhua,
"Borussia Dortmund 0.0,-0.5 @ 1.860

$100.00 Single",2020-10-18 10:56:35,100.0,0.0,-100.0,UCL,1.86,501.91,"Lazio vs Dortmund, 大崩盘的第二场
拉齐奥十年后重返欧冠第一场，我最熟悉的意甲养老队面对一只常年和拜仁打高强度对抗的球队居然都会爆冷...

反思：多特蒙德的比赛我没看过，没想到如此拉垮. 当然这场球问我依然觉得有问题",ASIAN HANDICAP,PRE MATCH,LOST,Lazio,Dortmund
"Man Utd 0.0 @ 1.880

$50.00 Single",2020-10-24 10:42:23,50.0,50.0,0.0,,1.88,501.91,,ASIAN HANDICAP,PRE MATCH,PUSH,Manchester United,
"Lazio 0.0,+0.5 @ 2.040

$30.00 Single",2020-10-28 14:34:53,30.0,30.47,0.47,UCL,2.04,502.38,"拉齐奥的比赛还是少碰吧, 假成马",ASIAN HANDICAP,PRE MATCH,CASH_OUT,Lazio,
"Barcelona to score 2nd goal @ 2.50

$30.47 Single",2020-10-28 16:24:24,30.47,76.18,45.71,UCL,2.5,548.09,"巴萨对尤文, 很难得能重一次live goal. 2.5的赔率回看起来还是不划算的(从概率来看3.0+才是一个合理的赔率. 后30分钟进球概率40% / 1.5 = 0.26)",TEAM TO SCORE,LIVE,WIN,Barcelona,Juventus
"Jiangsu Suning FC @ 3.60

$26.18 Single",2020-10-29 07:06:08,26.18,0.0,-26.18,CSL,3.6,521.91,苏宁 vs 上港,FINAL RESULT,PRE MATCH,LOST,,
"Man Utd @ 2.25

$20.00 Single",2020-11-01 12:02:15,20.0,0.0,-20.0,,2.25,501.91,,FINAL RESULT,PRE MATCH,LOST,Manchester United,
"Man Utd to score 2nd goal @ 2.87

$20.00 Single",2020-11-01 13:04:22,20.0,0.0,-20.0,,2.87,481.91,,TEAM TO SCORE,LIVE,LOST,Manchester United,
"Leeds @ 7.50

$30.00 Single",2020-11-02 16:07:09,30.0,0.0,-30.0,,7.5,451.91,,FINAL RESULT,PRE MATCH,LOST,Leeds United,
"Real Madrid -0.5 @ 2.020

$50.00 Single",2020-11-03 14:16:57,50.0,101.0,51.0,UCL,2.02,502.91,"Real Madrid vs Inter Milan
孔蒂傻逼，齐达内牛逼, 买就是了. 这就是我的偏执",ASIAN HANDICAP,PRE MATCH,WIN,Real Madrid,Inter
"Donald Trump @ 11.00

$11.00 Single",2020-11-05 17:49:13,11.0,0.0,-11.0,,11.0,491.91,,FINAL RESULT,PRE MATCH,LOST,,
"Man City -0.5,-1.0 @ 2.070

$90.00 Single",2020-11-21 12:17:40,90.0,0.0,-90.0,PL,2.07,401.91,"Tottenam vs Man city.
我对穆里尼奥有很大的偏见, 外加偏爱瓜迪奥拉, 所以这种失败不可避免

这个赛季曼城进攻端问题较大，这个我已经看出来，这场的注码买的是一个瓜迪奥拉刚刚续约（士气++), 这场投注应该控制在50以内",ASIAN HANDICAP,PRE MATCH,LOST,Manchester City,Tottenham
"Man City @ 4.50

$50.00 Single",2020-11-21 13:49:18,50.0,0.0,-50.0,,4.5,351.91,"Tottenam vs Man city.
曼城落后以后心态炸裂... 足球比赛逆转的概率究竟有多大? ",FINAL RESULT,LIVE,LOST,Manchester City,Tottenham
"Barcelona @ 8.50

$50.00 Single",2020-11-21 16:17:24,50.0,0.0,-50.0,,8.5,301.91,,FINAL RESULT,PRE MATCH,LOST,Barcelona,
"Leeds @ 3.25

$100.00 Single",2020-11-22 11:37:21,100.0,0.0,-100.0,PL,3.25,201.91,"Leeds vs Arsenal
让我直接原地爆炸的一场. Leeds全场压制, 浪射无数, 阿森纳下半场还被罚下一人...
这场复盘没有问题, 虽然我已输的怀疑人生",FINAL RESULT,PRE MATCH,LOST,Leeds United,Arsenal
"Leeds @ 3.00

$50.00 Single",2020-11-28 13:30:15,50.0,150.0,100.0,PL,3.0,301.91,"Everton vs Leeds
赛季Leeds比赛一场不落， 对两队都比较了解
当然投注Leeds主要还是情怀考虑. 这个队的问题就是练的太猛, 打法消耗太大,感觉赛季中期随着伤员的出现开始逐渐乏力(逼抢力度和节奏都有明显下降)",FINAL RESULT,PRE MATCH,WIN,Leeds United,Everton
"(0-0) Chelsea -0.5 @ 2.020

$50.00 Single",2020-11-29 11:18:56,50.0,0.0,-50.0,,2.02,251.91,,ASIAN HANDICAP,LIVE,LOST,Chelsea,
"Chelsea @ 2.40

$50.00 Single",2020-11-29 12:44:40,50.0,0.0,-50.0,,2.4,201.91,,FINAL RESULT,PRE MATCH,LOST,Chelsea,
"Chelsea @ 3.00

$50.00 Single",2020-11-29 13:01:43,50.0,0.0,-50.0,,3.0,151.91,,FINAL RESULT,PRE MATCH,LOST,Chelsea,
"RB Leipzig @ 2.10

$100.00 Single",2020-12-05 12:57:07,100.0,0.0,-100.0,Bundesliga,2.1,51.91,"RB Leipzig vs Bayern(3:3)
德甲我是从来不碰的, 这场是临场判断。拜仁比起上赛季总体是不如的, 感觉进攻很迷茫,.
RB倒是挺有特点, 反击很有针对性, 这个赛季适度看多.",FINAL RESULT,LIVE,LOST,Bayern Munich,RB Leipzig
"Leeds @ 6.00

$50.00 Single",2020-12-05 14:43:58,50.0,0.0,-50.0,,6.0,1.91,"Chelsea vs Leeds( 3:1)
赛前判断：吉鲁周中欧冠大四喜，本场继续首发
切尔西周中多打一场，吉鲁跑动能力堪忧，怀疑会被利兹联冲死。比赛过程利兹联早早进球，但是后面显出疲态，致命弱点防空在切尔西面前暴露，切尔西直接高空轰炸砸死
利兹联在接下来的一场也是领先后被西汉姆高空球直接砸死, 进攻开始显露疲态, Koch受伤3个月，短期看空.",FINAL RESULT,PRE MATCH,LOST,Leeds United,Chelsea
"Leeds to score 4th goal @ 4.50

$20.00 Single",2020-12-05 16:29:57,20.0,0.0,-20.0,,4.5,-18.09,"Chelsea vs Leeds
Leeds真是有点疲了",TEAM TO SCORE,LIVE,LOST,Leeds United,Chelsea
"Club Brugge +0.5,+1.0 @ 2.030

$50.00 Single",2020-12-07 23:01:30,50.0,80.28,30.28,UCL,2.03,12.19,"Lazio vs Brugge (2:2)
拉齐奥2:0领先后习惯性划水(打假球), 判断准确.
Early cashout的原因是Brugge必须赢才能出线, 最后守门员都会顶出来, 为了避免意外, 提前cashout",ASIAN HANDICAP,PRE MATCH,WIN,Lazio,
"Barcelona @ 2.15

$30.00 Single",2020-12-08 14:25:49,30.0,0.0,-30.0,UCL,2.15,-17.81,"Barcelona vs Juventus
争议点球判罚影响了比赛结果，过程来看没有问题",FINAL RESULT,PRE MATCH,LOST,Barcelona,Juventus
"Barcelona 0.0,-0.5 @ 1.880

$30.28 Single",2020-12-08 14:39:10,30.28,0.0,-30.28,UCL,1.88,-48.09,"Barcelona vs Juventus
争议点球判罚影响了比赛结果，过程来看没有问题",ASIAN HANDICAP,PRE MATCH,LOST,Barcelona,Juventus
"Barcelona to score 4th goal @ 2.50

$50.00 Single",2020-12-08 16:30:34,50.0,0.0,-50.0,UCL,2.5,-98.09,"Barcelona vs Juventus

心态崩，live goal的风控要做好: 
<$30 + odds > 3",TEAM TO SCORE,LIVE,LOST,Barcelona,Juventus
"AC Milan @ 2.10
$50.00 Single",2020-12-23 12:07:31,50.0,105.0,55.0,Serie A,2.1,-43.09,"AC milan vs Lazio
最后一分钟绝杀
难道这就是转运的开始?",FINAL RESULT,PRE MATCH,WIN,Lazio,AC Milan
"(0-0) Chelsea -0.5 @ 1.980

$55.00 Single",2020-12-26 12:40:44,55.0,0.0,-55.0,PL,1.98,-98.09,"Arsenal vs Chelsea
诱人的赔率，苦涩的结果
内忧外患的阿森纳(主力中卫组合伤停)赢了外强中干的切尔西, 这场有点假",ASIAN HANDICAP,LIVE,LOST,Chelsea,Arsenal
"Leeds +0.5 @ 1.875

$50.00 Single",2021-01-01 20:24:59,50.0,93.75,43.75,PL,1.875,-54.34,"Tottenam vs Leeds
角球大数据，突出一个稳",ASIAN HANDICAP,PRE MATCH,WIN,Leeds United,Tottenham
"Leeds @ 4.00

$20.00 Single",2021-01-02 06:34:45,20.0,0.0,-20.0,PL,4.0,-74.34,"Tottenham vs Leeds
小注搏冷, 风险控制得当",FINAL RESULT,PRE MATCH,LOST,Leeds United,Tottenham
"Leeds @ 8.50

$10.00 Single",2021-01-02 08:00:40,10.0,0.0,-10.0,PL,8.5,-84.34,"Tottenham vs Leeds
小注搏冷, 风险控制得当",FINAL RESULT,LIVE,LOST,Leeds United,Tottenham
"RB Leipzig @ 2.37

$23.75 Single",2021-01-09 13:00:04,23.75,0.0,-23.75,,2.37,-108.09,,FINAL RESULT,PRE MATCH,LOST,RB Leipzig,
"(0-1) Brighton 0.0 @ 2.300

$50.00 Single",2021-01-16 11:03:53,50.0,50.0,0.0,,2.3,-108.09,,ASIAN HANDICAP,LIVE,PUSH,,
"Liverpool -0.5 @ 1.950

$40.00 Single",2021-01-17 11:29:26,40.0,0.0,-40.0,,1.95,-148.09,,ASIAN HANDICAP,PRE MATCH,LOST,Liverpool,
"Inter Milan 0.0,-0.5 @ 2.020

$100.00 Single",2021-01-17 14:45:07,100.0,202.0,102.0,Serie A,2.02,-46.09,"Inter Milan 2:0 Juventus
国米三线都是意甲最强配置，硬实力第一无悬念
这场基耶利尼顶替博努奇首发， 复合更改i中卫组合原则，重注",ASIAN HANDICAP,PRE MATCH,WIN,Inter,Juventus
"Chelsea @ 2.00

$22.00 Single",2021-01-19 10:52:31,22.0,0.0,-22.0,,2.0,-68.09,,FINAL RESULT,PRE MATCH,LOST,Chelsea,
"Leicester 0.0 @ 2.020

$30.00 Single",2021-01-19 14:39:05,30.0,60.6,30.6,,2.02,-37.49,,ASIAN HANDICAP,PRE MATCH,WIN,Leichester,
"Atalanta 0.0,-0.5 @ 1.890

$30.60 Single",2021-01-23 11:56:00,30.6,57.84,27.24,,1.89,-10.25,,ASIAN HANDICAP,PRE MATCH,WIN,Atalanta,
"Lazio or Sassuolo @ 1.80

$27.84 Single",2021-01-24 13:26:48,27.84,41.76,13.92,,1.8,3.67,,FINAL RESULT,PRE MATCH,WIN,Lazio,
"Leeds -0.5 @ 1.940

$51.76 Single",2021-01-26 05:50:31,51.76,100.42,48.66,PL,1.94,52.33,Newcastle v Leeds,ASIAN HANDICAP,PRE MATCH,WIN,Leeds United,Newcastle
"Leeds to score 4th goal @ 2.62

$20.00 Single",2021-01-26 14:31:02,20.0,0.0,-20.0,,2.62,32.33,自从live bet开始控制风险后收益有所改善,TEAM TO SCORE,LIVE,LOST,Leeds United,
"Wolverhampton +0.5,+1.0 @ 2.030

$30.42 Single",2021-01-27 12:21:45,30.42,61.76,31.34,,2.03,63.67,,ASIAN HANDICAP,PRE MATCH,WIN,Wolverhampton,
"Liverpool -1.5 @ 1.750

$31.76 Single",2021-01-28 14:04:43,31.76,0.0,-31.76,,1.75,31.91,"Liverpool3:1 Tottenham
这个角球本来是稳胆的, 结果打出角球2:1, 利物浦的角球以后要谨慎",ASIAN CORNER HANDICAP,PRE MATCH,LOST,Liverpool,Tottenham
"Arsenal 0.0 @ 1.900

$50.00 Single",2021-01-30 10:04:05,50.0,0.0,-50.0,PL,1.9,-18.09,"Arsenal  0:0 Man U
角球大数据也不是完全准确",ASIAN CORNER HANDICAP,PRE MATCH,LOST,Manchester United,Arsenal
"Leeds +1.0 @ 1.850

$100.00 Single",2021-01-31 08:46:40,100.0,100.0,0.0,PL,1.85,-18.09,Leicester v Leeds(Asian Handicap Corners),ASIAN CORNER HANDICAP,PRE MATCH,PUSH,Leeds United,Leichester
"Leeds +0.5 @ 2.070

$50.00 Single",2021-01-31 08:48:22,50.0,103.5,53.5,PL,2.07,35.41,Leicester v Leeds,ASIAN HANDICAP,PRE MATCH,WIN,Leeds United,Leichester
"Brighton @ 3.25

$23.50 Single",2021-01-31 11:39:58,23.5,76.38,52.88,,3.25,88.29,,FINAL RESULT,PRE MATCH,WIN,,
"Leeds to score 4th goal @ 2.62

$30.00 Single",2021-02-03 16:00:16,30.0,0.0,-30.0,PL,2.62,58.29,"Leeds v Everton(Next Goal)
自从live bet开始控制风险后收益有所改善",TEAM TO SCORE,LIVE,LOST,Leeds United,Everton
"Chelsea -1.5 @ 1.900

$50.00 Single",2021-02-04 14:54:13,50.0,95.0,45.0,,1.9,103.29,,ASIAN HANDICAP,PRE MATCH,WIN,Chelsea,
"Chelsea @ 1.90

$30.00 Single",2021-02-04 15:06:58,30.0,57.28,27.28,,1.9,130.57,,FINAL RESULT,PRE MATCH,WIN,Chelsea,
"Sevilla -0.5,-1.0 @ 1.950

$50.00 Single",2021-02-06 11:42:21,50.0,97.5,47.5,La Liga,1.95,178.07,"Sevilla v Getafe
西甲弄的比较少。东窗戈麦斯加盟后对赛维利亚期待很高。目前来看磨合不及预期。奥坎波斯才是塞维利亚的阵眼，基本相当于2年前菲尔米诺之于利物浦",ASIAN HANDICAP,PRE MATCH,WIN,Sevilla,Getafe
"Everton +3.0 @ 1.800

$58.66 Single",2021-02-06 11:50:07,58.66,0.0,-58.66,PL,1.8,119.41,Man Utd v Everton(Asian Handicap Corners),ASIAN CORNER HANDICAP,PRE MATCH,LOST,Manchester United,Everton
"Roma to score 2nd goal @ 3.20

$10.00 Single",2021-02-06 13:22:03,10.0,0.0,-10.0,,3.2,109.41,,TEAM TO SCORE,LIVE,LOST,,
"Man City -0.5 @ 1.900

$57.50 Single",2021-02-07 11:25:02,57.5,0.0,-57.5,PL,1.9,51.91,"Liverpool v Man City  (1:4)
",ASIAN CORNER HANDICAP,PRE MATCH,LOST,Liverpool,Manchester City
"Leeds -0.5 @ 1.890

$100.00 Single",2021-02-08 14:35:30,100.0,189.0,89.0,,1.89,140.91,Leeds v Crystal Palace (Asian Handicap),ASIAN HANDICAP,PRE MATCH,WIN,Leeds United,
"Inter Milan 0.0,-0.5 @ 1.950

$30.00 Single",2021-02-09 14:43:32,30.0,15.0,-15.0,,1.95,125.91,,ASIAN HANDICAP,PRE MATCH,LOST,Inter,
"Liverpool -1.5 @ 1.950

$50.00 Single",2021-02-12 23:15:12,50.0,50.0,0.0,,1.95,125.91,,ASIAN HANDICAP,PRE MATCH,PUSH,Liverpool,
"Leicester +0.5 @ 1.900

$24.00 Single",2021-02-13 06:53:46,24.0,45.6,21.6,,1.9,147.51,,ASIAN HANDICAP,PRE MATCH,WIN,Leichester,
"Napoli 0.0 @ 1.775

$25.60 Single",2021-02-13 11:12:08,25.6,0.0,-25.6,,1.775,121.91,,ASIAN HANDICAP,PRE MATCH,LOST,Napoli,
"Over 3.0 @ 2.040

$20.00 Single",2021-02-14 11:26:26,20.0,36.41,16.41,,2.04,138.32,,TOTAL GOAL,PRE MATCH,WIN,,
"Under 2.5 @ 2.10

$26.41 Single",2021-02-14 14:41:39,26.41,0.0,-26.41,,2.1,111.91,,TOTAL GOAL,PRE MATCH,LOST,,
"No @ 2.00

$30.00 Single",2021-02-14 14:41:59,30.0,0.0,-30.0,,2.0,81.91,,BTTS,PRE MATCH,LOST,,
"RB Leipzig 0.0,+0.5 @ 1.900

$30.00 Single",2021-02-16 09:47:11,30.0,0.0,-30.0,,1.9,51.91,,ASIAN HANDICAP,PRE MATCH,LOST,RB Leipzig,
"Under 2.5,3.0 @ 2.050

$30.00 Single",2021-02-16 09:47:30,30.0,61.5,31.5,,2.05,83.41,,TOTAL GOAL,PRE MATCH,WIN,,
"PSG +0.5,+1.0 @ 1.920

$20.00 Single",2021-02-16 14:06:41,20.0,38.4,18.4,,1.92,101.81,,ASIAN HANDICAP,PRE MATCH,WIN,Paris SG,
"No 1st goal @ 6.50

$20.00 Single",2021-02-16 15:34:57,20.0,0.0,-20.0,,6.5,81.81,,UNKNOWN,PRE MATCH,LOST,,
"Sevilla 0.0,-0.5 @ 2.040

$100.00 Single",2021-02-16 23:13:21,100.0,0.0,-100.0,,2.04,-18.19,"Sevilla 2:3 Dortmund
哈兰德暴走...这个因素赛前也考虑到了. 多特蒙德哈兰德是无解的, 但是考虑到多特打拉齐奥的表现，还是信了一手塞维利亚
塞维利亚的主要问题: 没奥坎波斯打不了, 拉基蒂奇坑逼. 戈麦斯融入不够, 球权太少. 替补左后卫上不去，左路进攻基本瘫痪.
",ASIAN HANDICAP,PRE MATCH,LOST,Sevilla,Dortmund
"Leeds +1.0 @ 1.800

$79.90 Single",2021-02-19 11:20:09,79.9,79.9,0.0,,1.8,-18.19,,ASIAN HANDICAP,PRE MATCH,PUSH,Leeds United,
"Leeds +0.5 @ 2.025

$29.90 Single",2021-02-19 14:49:12,29.9,60.55,30.65,,2.025,12.46,,ASIAN HANDICAP,PRE MATCH,WIN,Leeds United,
"Sampdoria +1.0 @ 1.900

$20.55 Single",2021-02-20 09:01:11,20.55,20.55,0.0,,1.9,12.46,,ASIAN HANDICAP,PRE MATCH,PUSH,,
"Under 3.0 @ 2.030

$30.55 Single",2021-02-20 11:52:06,30.55,62.02,31.47,,2.03,43.93,,TOTAL GOAL,PRE MATCH,WIN,,
"Everton +3.5 @ 2.050

$20.00 Single",2021-02-20 11:55:20,20.0,0.0,-20.0,,2.05,23.93,,ASIAN HANDICAP,PRE MATCH,LOST,Everton,
"Inter Milan -0.5 @ 1.990

$32.02 Single",2021-02-20 23:54:38,32.02,63.72,31.7,SerieA,1.99,55.63,"Inter 3:0 AC milan
正常的结果，弥补一下第一回合的损失",ASIAN HANDICAP,PRE MATCH,WIN,Inter,AC Milan
"Inter Milan -0.5 @ 1.850

$100.00 Single",2021-02-21 08:51:13,100.0,185.0,85.0,SerieA,1.85,140.63,"Inter 3:0 AC milan
正常的结果，弥补一下第一回合的损失",ASIAN HANDICAP,PRE MATCH,WIN,Inter,AC Milan
"Inter Milan to score 2nd goal @ 2.00

$30.00 Single",2021-02-21 10:11:52,30.0,60.0,30.0,SerieA,2.0,170.63,"Inter 3:0 AC milan
这个live在米兰起势的时候反追一手国米进球, 有点意思",TEAM TO SCORE,LIVE,WIN,Inter,AC Milan
"No @ 1.95

$30.00 Single",2021-02-21 10:44:47,30.0,58.5,28.5,,1.95,199.13,,BTTS,PRE MATCH,WIN,,
"Bayern Munich -0.5,-1.0 @ 1.850

$97.22 Single",2021-02-21 13:36:30,97.22,179.86,82.64,UCL,1.85,281.77,"Bayern 4: 1 Lazio
赛季翻身仗. 拜仁赛前有利空: 格纳布里，穆勒打不了, 加上拉齐奥意甲7连胜使得赔率相当划算",ASIAN HANDICAP,PRE MATCH,WIN,Bayern Munich,Lazio
"Bayern Munich -0.5,-1.0 @ 1.850

$100.00 Single",2021-02-22 08:43:18,100.0,185.0,85.0,,1.85,366.77,"Bayern 4: 1 Lazio
赛季翻身仗. 拜仁赛前有利空: 格纳布里，穆勒打不了, 加上拉齐奥意甲7连胜使得赔率相当划算",ASIAN HANDICAP,PRE MATCH,WIN,Bayern Munich,Lazio
"Over 2.5 @ 1.66

$100.00 Single",2021-02-23 07:40:31,100.0,166.67,66.67,PL,1.66,433.44,Leeds v Southampton(Total Goals),TOTAL GOAL,PRE MATCH,WIN,Leeds United,Southampton
"No @ 2.25

$50.00 Single",2021-02-23 23:35:33,50.0,112.5,62.5,UCL,2.25,495.94,Atalanta v Real Madrid(Both Teams to Score),BTTS,PRE MATCH,WIN,Real Madrid,Atalanta
"Leeds -1.0 @ 1.975

$94.03 Single",2021-02-27 11:24:47,94.03,185.71,91.68,PL,1.975,587.62,"Leeds 0:1 Aston villa
有点悬, 险胜",ASIAN CORNER HANDICAP,PRE MATCH,WIN,Leeds United,
"Leeds to score 2nd goal @ 2.00

$20.00 Single",2021-02-27 13:43:09,20.0,0.0,-20.0,,2.0,567.62,,TEAM TO SCORE,LIVE,LOST,Leeds United,
"Arsenal +0.5 @ 2.000

$45.71 Single",2021-02-27 20:45:22,45.71,91.42,45.71,,2.0,613.33,,ASIAN HANDICAP,PRE MATCH,WIN,Arsenal,
"Liverpool -3.0 @ 1.850

$50.00 Single",2021-02-28 08:58:43,50.0,0.0,-50.0,UCL,1.85,563.33,"Liverpool 2:0 Sheffield
打联赛副班长, 这个角球看上去应该挺稳的。 结果最后利物浦角球还输了一个，无语...利物浦的角球以后要谨慎",ASIAN CORNER HANDICAP,PRE MATCH,LOST,Liverpool,
"No @ 2.05

$21.42 Single",2021-02-28 11:28:18,21.42,43.92,22.5,,2.05,585.83,,BTTS,PRE MATCH,WIN,,
"(0-0) Man Utd 0.0 @ 2.200

$30.00 Single",2021-02-28 11:52:51,30.0,30.0,0.0,,2.2,585.83,,ASIAN HANDICAP,LIVE,PUSH,Manchester United,
"Sevilla +1.0,+1.5 @ 1.825

$30.00 Single",2021-03-03 14:34:05,30.0,0.0,-30.0,,1.825,555.83,,ASIAN HANDICAP,PRE MATCH,LOST,Sevilla,
"Bayern Munich -1.0 @ 1.940

$53.92 Single",2021-03-05 23:44:37,53.92,104.61,50.69,Bundesliga,1.94,606.52,"Bayern Munich v Borussia Dortmund(Asian Handicap)
拜仁开场先输个0:2, 随后4:2逆转
投注理由: 多特防守一般, 桑乔缺阵",ASIAN HANDICAP,PRE MATCH,WIN,Bayern Munich,Dortmund
"Bayern Munich -1.0 @ 1.930

$100.00 Single",2021-03-06 06:14:39,100.0,193.0,93.0,Bundesliga,1.93,699.52,"Bayern Munich v Borussia Dortmund(Asian Handicap)
拜仁开场先输个0:2, 随后4:2逆转
投注理由: 多特防守一般, 桑乔缺阵",ASIAN HANDICAP,PRE MATCH,WIN,Bayern Munich,Dortmund
"Juventus -0.5 @ 1.960

$100.00 Single",2021-03-06 10:26:25,100.0,191.22,91.22,,1.96,790.74,"Juventus v Lazio(Asian Handicap)
投注理由: 目测本赛季因莫比莱状态奇差无比",ASIAN HANDICAP,PRE MATCH,WIN,Lazio,Juventus
"Bayern Munich -2.0 @ 3.450

$30.00 Single",2021-03-06 11:46:28,30.0,30.0,0.0,,3.45,790.74,,ASIAN HANDICAP,PRE MATCH,PUSH,Bayern Munich,
"Bayern Munich @ 1.83

$50.00 Single",2021-03-06 13:56:14,50.0,91.67,41.67,,1.83,832.41,"Bayern Munich v Borussia Dortmund(Asian Handicap)
拜仁开场先输个0:2, 随后4:2逆转
投注理由: 多特防守一般, 桑乔缺阵",FINAL RESULT,PRE MATCH,WIN,Bayern Munich,Dortmund
"Juventus @ 2.25

$30.00 Single",2021-03-06 15:50:16,30.0,65.52,35.52,Serie A,2.25,867.93,"Juventus v Lazio
投注理由: 目测本赛季因莫比莱状态奇差无比",FINAL RESULT,PRE MATCH,WIN,Lazio,Juventus
"No @ 1.80

$36.02 Single",2021-03-07 08:59:09,36.02,0.0,-36.02,La liga,1.8,831.91,"Atletico Madrid v Real Madrid(Both Teams to Score)
1:1
伤不起...马竞前场抢断反击进了一个",BTTS,PRE MATCH,LOST,Real Madrid,Atletico Madrid
"RB Leipzig @ 7.00

$30.00 Single",2021-03-07 11:13:59,30.0,0.0,-30.0,UCL,7.0,801.91,"Liverpool v RB Leipzig(To Qualify)
投注理由: 利物浦英超主场5连败, 有崩盘的迹象
7倍赔率值的投机",FINAL RESULT,PRE MATCH,LOST,Liverpool,RB Leipzig
"RB Leipzig @ 3.00

$30.00 Single",2021-03-07 11:17:42,30.0,0.0,-30.0,UCL,3.0,771.91,"Liverpool v RB Leipzig 2:0
投机一下.
比赛过程很出乎意料, 莱比锡没有Angeliho真的
打不了.",FINAL RESULT,PRE MATCH,LOST,Liverpool,RB Leipzig
"Man Utd -0.5,-1.0 @ 1.900

$50.00 Single",2021-03-07 12:21:18,50.0,0.0,-50.0,UCL,1.9,721.91,"Man Utd v AC Milan(Asian Handicap) 1:1
阵容残缺的米兰补时绝平, 曼联也算是大热死吧...",ASIAN HANDICAP,PRE MATCH,LOST,Manchester United,AC Milan
"Leeds to score 3rd goal @ 2.40

$20.00 Single",2021-03-08 16:16:07,20.0,0.0,-20.0,,2.4,701.91,,TEAM TO SCORE,LIVE,LOST,Leeds United,
"Sevilla 0.0,+0.5 @ 2.000

$50.00 Single",2021-03-09 14:04:28,50.0,75.0,25.0,,2.0,726.91,,ASIAN HANDICAP,PRE MATCH,WIN,Sevilla,
"Sevilla -0.5 @ 1.875

$50.00 Single",2021-03-09 14:36:10,50.0,93.75,43.75,,1.875,770.66,,ASIAN HANDICAP,PRE MATCH,WIN,Sevilla,
"Sevilla -1.5 @ 6.800

$20.00 Single",2021-03-09 14:38:08,20.0,0.0,-20.0,,6.8,750.66,,ASIAN HANDICAP,PRE MATCH,LOST,Sevilla,
"RB Leipzig @ 4.00

$28.75 Single",2021-03-10 16:19:15,28.75,0.0,-28.75,,4.0,721.91,,FINAL RESULT,PRE MATCH,LOST,RB Leipzig,
"Shakhtar Donetsk +1.0 @ 1.850

$20.00 Single",2021-03-10 22:54:59,20.0,0.0,-20.0,,1.85,701.91,,ASIAN HANDICAP,PRE MATCH,LOST,Shakhtar Donetsk,
"No @ 2.05

$20.00 Single",2021-03-10 23:06:01,20.0,41.0,21.0,UCL,2.05,722.91,Roma v Shakhtar Donetsk(Both Teams to Score),BTTS,PRE MATCH,WIN,Shakhtar Donetsk,
"No @ 1.95

$20.00 Single",2021-03-10 23:06:52,20.0,0.0,-20.0,UCL,1.95,702.91,"Man Utd v AC Milan(Both Teams to Score)
很久不玩BTTS了, AC米兰93分钟进了一个，伤不起
杯赛淘汰赛赔率合适的话还是可以玩玩btts",BTTS,PRE MATCH,LOST,Manchester United,AC Milan
"Leeds @ 4.80

$21.00 Single",2021-03-13 06:40:32,21.0,0.0,-21.0,,4.8,681.91,,FINAL RESULT,PRE MATCH,LOST,Leeds United,
"Leeds +0.5,+1.0 @ 1.990

$50.00 Single",2021-03-13 06:40:41,50.0,99.5,49.5,PL,1.99,731.41,"Leeds v Chelsea(Asian Handicap) 0: 0
投注理由: 切尔西接下来周中欧冠生死战
首发阵容明显留力",ASIAN HANDICAP,PRE MATCH,WIN,Leeds United,Chelsea
"Leeds +1.5 @ 1.825

$80.00 Single",2021-03-13 06:41:15,80.0,146.0,66.0,PL,1.825,797.41,Leeds v Chelsea(Asian Handicap Corners),ASIAN CORNER HANDICAP,PRE MATCH,WIN,Leeds United,Chelsea
"Leeds @ 5.25

$20.00 Single",2021-03-13 07:28:52,20.0,0.0,-20.0,,5.25,777.41,,FINAL RESULT,PRE MATCH,LOST,Leeds United,
"Leeds or Draw @ 1.90

$30.00 Single",2021-03-13 08:05:57,30.0,57.28,27.28,,1.9,804.69,"Leeds v Chelsea(Asian Handicap)
滚球",FINAL RESULT,LIVE,WIN,Leeds United,Chelsea
"Over 1.5,2.0 @ 1.810

$30.00 Single",2021-03-13 14:45:43,30.0,0.0,-30.0,,1.81,774.69,,TOTAL GOAL,PRE MATCH,LOST,,
"Over 1.5,2.0 @ 1.810

$22.78 Single",2021-03-13 14:55:36,22.78,0.0,-22.78,,1.81,751.91,,TOTAL GOAL,PRE MATCH,LOST,,
"Arsenal -1.0 @ 1.850

$50.00 Single",2021-03-14 10:43:21,50.0,92.5,42.5,PL,1.85,794.41,"Arsenal v Tottenham(2: 1)
打热刺这个角球还是很稳的",ASIAN CORNER HANDICAP,PRE MATCH,WIN,Tottenham,Arsenal
"Arsenal 0.0 @ 1.940

$50.00 Single",2021-03-14 11:27:34,50.0,97.0,47.0,PL,1.94,841.41,Arsenal v Tottenham(2: 1),ASIAN HANDICAP,PRE MATCH,WIN,Tottenham,Arsenal
"Arsenal @ 2.60

$20.00 Single",2021-03-14 12:43:43,20.0,52.0,32.0,,2.6,873.41,"Arsenal v Tottenham(2: 1)
最近滚球还有点顺，风险控制也合适i",FINAL RESULT,LIVE,WIN,Tottenham,Arsenal
"Liverpool -1.5 @ 1.800

$51.50 Single",2021-03-15 14:13:37,51.5,0.0,-51.5,PL,1.8,821.91,"Wolverhampton v Liverpool(Asian Handicap Corners)
利物浦角球的variance比较大
以后投注角球要好好考虑variance和赔率是否划算
这场角球数利物浦2:3输给狼队",ASIAN CORNER HANDICAP,PRE MATCH,LOST,Liverpool,Wolverhampton
"Real Madrid 0.0 @ 2.000

$50.00 Single",2021-03-16 14:32:36,50.0,0.0,-50.0,UCL,2.0,771.91,"Real Madrid v Atalanta(Corner)
赢球输角，常规操作",ASIAN CORNER HANDICAP,PRE MATCH,LOST,Real Madrid,Atalanta
"(0-0) Real Madrid 0.0,-0.5 @ 2.100

$70.00 Single",2021-03-16 15:12:07,70.0,147.0,77.0,UCL,2.1,848.91,"Real Madrid v Atalanta(Asian Handicap)
亚特兰大东窗走核心戈麦斯, 偏向于看空
实际比赛过程皇马赢得很轻松",ASIAN HANDICAP,LIVE,WIN,Real Madrid,Atalanta
"Chelsea 0.0,-0.5 @ 1.990

$27.00 Single",2021-03-16 16:55:47,27.0,27.0,0.0,,1.99,848.91,,ASIAN HANDICAP,PRE MATCH,PUSH,Chelsea,
"Chelsea -0.5 @ 1.900

$20.00 Single",2021-03-17 11:17:38,20.0,20.0,0.0,,1.9,848.91,,ASIAN HANDICAP,PRE MATCH,PUSH,Chelsea,
"Chelsea 0.0,-0.5 @ 2.020

$20.00 Single",2021-03-17 14:45:08,20.0,20.0,0.0,,2.02,848.91,,ASIAN HANDICAP,PRE MATCH,PUSH,Chelsea,
"Atletico Madrid to score 2nd goal @ 3.60

$27.00 Single",2021-03-17 16:17:17,27.0,0.0,-27.0,,3.6,821.91,,TEAM TO SCORE,LIVE,LOST,Atletico Madrid,
"Atletico Madrid to score 2nd goal @ 4.00

$20.00 Single",2021-03-17 16:19:59,20.0,0.0,-20.0,,4.0,801.91,,TEAM TO SCORE,LIVE,LOST,Atletico Madrid,
"Man Utd -0.5 @ 2.000

$100.00 Single",2021-03-18 11:22:38,100.0,100.0,0.0,UCL,2.0,801.91,"AC Milan v Man Utd (0:1)
首回合1:1, 次回合曼联取胜才能晋级
曼联很热, 米兰很多主力缺阵,
但是欧联杯还是要控制风险为主, 
这一单我cash out了",ASIAN HANDICAP,PRE MATCH,PUSH,Manchester United,AC Milan
"Man Utd 0.0 @ 1.800

$50.00 Single",2021-03-18 11:22:49,50.0,50.0,0.0,UCL,1.8,801.91,"AC Milan v Man Utd (Asian handicap corner)
首回合1:1, 次回合曼联取胜才能晋级
",ASIAN CORNER HANDICAP,PRE MATCH,CASH_OUT,Manchester United,AC Milan
"Man Utd -0.5 @ 1.975

$30.00 Single",2021-03-18 11:47:13,30.0,59.25,29.25,UCL,1.975,831.16,"AC Milan v Man Utd (0:1)
首回合1:1, 次回合曼联取胜才能晋级",ASIAN HANDICAP,PRE MATCH,WIN,Manchester United,AC Milan
"Leeds 0.0 @ 2.050

$59.25 Single",2021-03-18 16:56:53,59.25,121.47,62.22,PL,2.05,893.38,"Fulham v Leeds(1:2)
fulham要保级, 利兹联排名无欲无求. 赛前赔率
看好fulham",ASIAN HANDICAP,PRE MATCH,WIN,Leeds United,
"Leeds 0.0 @ 1.800

$20.00 Single",2021-03-19 09:13:06,20.0,0.0,-20.0,PL,1.8,873.38,"Fulham v Leeds(1:2)
角球，风险控制得当, 合理对冲胜负盘",ASIAN CORNER HANDICAP,PRE MATCH,LOST,Leeds United,
"Leeds 0.0 @ 2.070

$30.00 Single",2021-03-19 14:58:48,30.0,62.1,32.1,,2.07,905.48,,ASIAN HANDICAP,PRE MATCH,WIN,Leeds United,
"Leeds @ 2.60

$30.00 Single",2021-03-19 15:22:12,30.0,78.0,48.0,,2.6,953.48,,FINAL RESULT,PRE MATCH,WIN,Leeds United,
"Arsenal -0.5 @ 1.900

$51.57 Single",2021-03-20 22:37:22,51.57,97.99,46.42,,1.9,999.9,,ASIAN HANDICAP,PRE MATCH,WIN,Arsenal,
"Arsenal -0.5 @ 1.900

$30.00 Single",2021-03-21 09:57:28,30.0,57.0,27.0,,1.9,1026.9,,ASIAN HANDICAP,PRE MATCH,WIN,Arsenal,
"Aston Villa 0.0,+0.5 @ 2.020

$24.99 Single",2021-03-21 12:02:14,24.99,0.0,-24.99,,2.02,1001.91,,ASIAN HANDICAP,PRE MATCH,LOST,,
"Aston Villa @ 3.00

$20.00 Single",2021-03-21 14:39:22,20.0,0.0,-20.0,,3.0,981.91,,FINAL RESULT,PRE MATCH,LOST,,
"Sevilla 0.0 @ 2.020

$50.00 Single",2021-04-02 17:57:22,50.0,101.0,51.0,La liga,2.02,1032.91,Sevilla v Atletico Madrid(Asian Handicap),ASIAN HANDICAP,PRE MATCH,WIN,Atletico Madrid,Sevilla
"Leeds -1.0 @ 1.940

$30.00 Single",2021-04-02 17:57:52,30.0,30.0,0.0,PL,1.94,1032.91,,ASIAN HANDICAP,PRE MATCH,PUSH,Leeds United,
"Leeds to score 4th goal @ 1.95

$20.00 Single",2021-04-03 10:30:21,20.0,0.0,-20.0,PL,1.95,1012.91,,TEAM TO SCORE,LIVE,LOST,Leeds United,
"Bayern Munich 0.0 @ 1.960

$110.00 Single",2021-04-03 11:26:51,110.0,215.6,105.6,Bundesliga,1.96,1118.51,RB Leipzig v Bayern Munich(Asian Handicap),ASIAN HANDICAP,PRE MATCH,WIN,Bayern Munich,RB Leipzig
"Liverpool @ 2.62

$20.00 Single",2021-04-03 15:19:52,20.0,52.5,32.5,,2.62,1151.01,,FINAL RESULT,PRE MATCH,WIN,Liverpool,
"Real Madrid 0.0 @ 1.950

$48.10 Single",2021-04-03 20:53:25,48.1,44.46,-3.64,UCL,1.95,1147.37,Real Madrid v Liverpool(Asian Handicap),ASIAN HANDICAP,PRE MATCH,CASH_OUT,Real Madrid,Liverpool
"Liverpool 0.0,-0.5 @ 2.100

$25.46 Single",2021-04-06 11:52:07,25.46,23.25,-2.21,UCL,2.1,1145.16,,ASIAN HANDICAP,PRE MATCH,CASH_OUT,Liverpool,
"Man City -1.5 @ 2.010

$20.00 Single
($20.00 Bet Credits)",2021-04-06 11:56:32,20.0,20.0,0.0,,2.01,1145.16,,ASIAN HANDICAP,PRE MATCH,PUSH,Manchester City,
"Liverpool 0.0 @ 2.020

$20.00 Single",2021-04-06 13:55:56,20.0,0.0,-20.0,UCL,2.02,1125.16,"Real Madrid 3: 1 Liverpool
https://www.notion.so/match-notes-938aa441680746cda6913d06e8d9ced0",ASIAN HANDICAP,PRE MATCH,LOST,Real Madrid,Liverpool
"Liverpool 0.0 @ 2.020

$23.25 Single",2021-04-06 13:56:37,23.25,0.0,-23.25,UCL,2.02,1101.91,"Real Madrid 3: 1 Liverpool
https://www.notion.so/match-notes-938aa441680746cda6913d06e8d9ced0",ASIAN HANDICAP,PRE MATCH,LOST,Real Madrid,Liverpool
"PSG +0.5 @ 1.880

$50.00 Single",2021-04-07 13:51:16,50.0,94.0,44.0,UCL,1.88,1145.91,,ASIAN HANDICAP,PRE MATCH,WIN,Paris SG,
"PSG to score 2nd goal @ 2.40

$20.00 Single",2021-04-07 14:08:01,20.0,48.0,28.0,UCL,2.4,1173.91,,TEAM TO SCORE,LIVE,WIN,Paris SG,
"PSG @ 2.10

$20.00 Single",2021-04-07 14:15:55,20.0,42.0,22.0,UCL,2.1,1195.91,,FINAL RESULT,PRE MATCH,WIN,Paris SG,
"PSG to score 6th goal @ 3.75

$20.00 Single",2021-04-07 15:31:31,20.0,0.0,-20.0,UCL,3.75,1175.91,,TEAM TO SCORE,LIVE,LOST,Paris SG,
"Leeds +1.5 @ 2.050

$34.00 Single",2021-04-07 21:19:03,34.0,69.7,35.7,PL,2.05,1211.61,"Leeds 2:1 Man City
利兹联队下半场少打一人，最后时刻逆转
投注依据: 曼城周中欧冠生死战, 这场必须轮换+大保健踢法
瓜迪奥拉在联赛无压力的强况下也有可能要卖贝尔萨一个人情
",ASIAN HANDICAP,PRE MATCH,WIN,Leeds United,Manchester City
"Barcelona 0.0,-0.5 @ 2.060

$40.00 Single",2021-04-09 11:10:11,40.0,0.0,-40.0,La liga,2.06,1171.61,"Real Madrid 2:1 Barcelona(Both Teams to Score)
基本面方面皇马周中欧冠苦战, 主力后卫瓦拉内缺阵. 这是一场决定冠军归属的关键战 (第二vs第一)
巴萨专注联赛，多休息3天",ASIAN HANDICAP,PRE MATCH,LOST,Real Madrid,Barcelona
"Union Berlin +0.5,+1.0 @ 1.930

$40.00 Single",2021-04-10 07:42:54,40.0,77.2,37.2,Bundesliga,1.93,1208.81,"Bayern 1:1 Union Berlin
最近拜仁比较关注, 比赛也搞得比较多
拜仁的问题就是双线疲惫, 伤病压力太大(莱万, 格纳布里). 所以赌一手双线崩盘",ASIAN HANDICAP,PRE MATCH,WIN,Bayern Munich,
"Union Berlin @ 4.50

$30.00 Single",2021-04-10 07:51:46,30.0,30.0,0.0,Bundesliga,4.5,1208.81,,FINAL RESULT,PRE MATCH,CASH_OUT,,
"No @ 2.62

$30.00 Single",2021-04-10 13:59:49,30.0,0.0,-30.0,La liga,2.62,1178.81,"Real Madrid 2:1 Barcelona(Both Teams to Score)
基本面方面皇马周中欧冠苦战, 主力后卫瓦拉内缺阵. 这是一场决定冠军归属的关键战 (第二vs第一)
巴萨专注联赛，多休息3天",BTTS,PRE MATCH,LOST,Real Madrid,Barcelona
"Barcelona @ 4.00

$30.00 Single",2021-04-10 14:19:39,30.0,0.0,-30.0,La liga,4.0,1148.81,"Real Madrid 2:1 Barcelona
实时滚球",FINAL RESULT,LIVE,LOST,Real Madrid,Barcelona
"Barcelona @ 8.00

$20.00 Single",2021-04-10 15:18:03,20.0,0.0,-20.0,La liga,8.0,1128.81,Real Madrid 2:1 Barcelona,FINAL RESULT,LIVE,LOST,Real Madrid,Barcelona
"Man Utd -0.5 @ 1.875

$126.90 Single",2021-04-11 10:21:37,126.9,0.0,-126.9,PL,1.875,1001.91,Tottenham v Man Utd(Asian Handicap Corners),ASIAN CORNER HANDICAP,PRE MATCH,LOST,Manchester United,Tottenham
"Man Utd 0.0,-0.5 @ 2.100

$20.00 Single",2021-04-11 10:29:43,20.0,42.0,22.0,PL,2.1,1023.91,"Tottenham v Man Utd(Asian Handicap)
曼联3: 1赢球, 但是角球没打出来.
曼联的角球属于高均值低variance, 本场卡瓦尼首发，曼联战意拉满, 投注理由充分",ASIAN HANDICAP,PRE MATCH,WIN,Manchester United,Tottenham
"FC Porto +0.5 @ 2.080

$22.00 Single",2021-04-13 13:07:46,22.0,45.76,23.76,UCL,2.08,1047.67,,ASIAN HANDICAP,PRE MATCH,WIN,,
"PSG 0.0,+0.5 @ 1.950

$50.00 Single",2021-04-13 13:10:48,50.0,0.0,-50.0,UCL,1.95,997.67,Paris 0:1 Bayern ,ASIAN HANDICAP,PRE MATCH,LOST,Bayern Munich,Paris SG
"PSG 0.0,+0.5 @ 1.950

$50.00 Single",2021-04-13 13:10:56,50.0,0.0,-50.0,UCL,1.95,947.67,Paris 0:1 Bayern ,ASIAN HANDICAP,PRE MATCH,LOST,Bayern Munich,Paris SG
"FC Porto @ 4.60

$50.00 Single",2021-04-13 13:23:24,50.0,230.0,180.0,UCL,4.6,1127.67,"Porto 1: 0 Chelsea
合理博冷. 切尔西这个队挺狗的, 第二回合在确保出线的情况下狗着踢",FINAL RESULT,PRE MATCH,WIN,Chelsea,
"FC Porto to score 1st goal @ 5.50

$50.00 Single",2021-04-13 15:30:45,50.0,275.0,225.0,UCL,5.5,1352.67,"Porto 1: 0 Chelsea
合理博冷. 切尔西这个队挺狗的, 第二回合在确保出线的情况下狗着踢",TEAM TO SCORE,LIVE,WIN,Chelsea,
"Man City -1.0 @ 2.080

$50.76 Single",2021-04-13 16:43:31,50.76,50.76,0.0,UCL,2.08,1352.67,"Man City 2:1 Dortmund
欧冠第二回合, 投注理由: 多特蒙德打拉齐奥都他妈费力...
哈兰德大概率走人, 多特这种年年卖人赚钱的队真心不看好, 球员踢球都是为了卖个好价钱
瓜迪奥拉现在是越来越经济实惠了, 能赢一球绝不赢两球",ASIAN HANDICAP,PRE MATCH,PUSH,Manchester City,Dortmund
"Man City -1.0 @ 2.080

$50.00 Single",2021-04-13 21:31:22,50.0,50.0,0.0,UCL,2.08,1352.67,,ASIAN HANDICAP,PRE MATCH,PUSH,Manchester City,
"Liverpool -0.5 @ 1.980

$50.00 Single",2021-04-14 04:41:56,50.0,0.0,-50.0,UCL,1.98,1302.67,"Liverpool 0:0 Real Madrid
次回合利物浦需要2:0才能晋级",ASIAN HANDICAP,PRE MATCH,LOST,Real Madrid,Liverpool
"Liverpool @ 2.75

$20.00 Single",2021-04-14 15:28:34,20.0,0.0,-20.0,UCL,2.75,1282.67,,FINAL RESULT,LIVE,LOST,Liverpool,
"Arsenal -0.5,-1.0 @ 2.020

$80.76 Single",2021-04-15 13:24:09,80.76,163.14,82.38,UCL,2.02,1365.05,"Arsenal 4: 0 xxxx
欧联杯, 投注依据: arsenal 虐菜指数挺高, 打弱队经常能形成压制优势
萨卡付出，坑逼奥巴梅扬没上",ASIAN HANDICAP,PRE MATCH,WIN,Arsenal,
"Wolfsburg +0.5 @ 1.990

$33.14 Single",2021-04-17 08:09:05,33.14,0.0,-33.14,Bundesliga,1.99,1331.91,"Bayern 1:0 Wolfsburg
最近拜仁比较关注, 比赛也搞得比较多
拜仁的问题就是双线疲惫, 伤病压力太大(莱万, 格纳布里). 所以赌一手双线崩盘",ASIAN HANDICAP,PRE MATCH,LOST,Bayern Munich,
"Man City -1.5 @ 1.850

$30.00 Single",2021-04-17 11:30:44,30.0,55.5,25.5,PL,1.85,1357.41,"Chelsea 1: 0 Man City
足总杯半决赛, 双方都是划水. 完全没上强度",ASIAN CORNER HANDICAP,PRE MATCH,WIN,Chelsea,Manchester City
"Draw @ 4.50

$35.50 Single",2021-04-18 22:52:07,35.5,159.75,124.25,PL,4.5,1481.66,"Leeds 1:1 Liverpool
打到这个阶段, 利兹联的比赛拿捏的死死的
独平都能压中...",FINAL RESULT,PRE MATCH,WIN,Leeds United,Liverpool
"Leeds +2.0 @ 1.800

$50.00 Single",2021-04-18 22:52:31,50.0,90.0,40.0,PL,1.8,1521.66,,ASIAN CORNER HANDICAP,PRE MATCH,WIN,Leeds United,
"Shandong Taishan -1.0 @ 1.875

$39.75 Single",2021-04-20 06:09:14,39.75,74.54,34.79,CSL,1.875,1556.45,"山东2:0 xxx
今年CSL开门红",ASIAN HANDICAP,PRE MATCH,WIN,,
"(0-0) Brighton +0.5 @ 2.075

$34.54 Single",2021-04-20 14:29:18,34.54,71.68,37.14,,2.075,1593.59,,ASIAN HANDICAP,LIVE,WIN,,
"Over 2.5,3.0 @ 1.970

$51.68 Single",2021-04-21 03:41:01,51.68,76.75,25.07,PL,1.97,1618.66,"Tottenham 2:1 Southampton
投注理由: 热刺换帅,  肯定不会再狗了...
南安普顿也是高位压迫开放型打法, 直接去大球",TOTAL GOAL,PRE MATCH,WIN,Tottenham,Southampton
"Over 2.5,3.0 @ 2.010

$40.00 Single",2021-04-21 11:18:29,40.0,60.2,20.2,PL,2.01,1638.86,"Tottenham 2:1 Southampton
投注理由: 热刺换帅,  肯定不会再狗了...
南安普顿也是高位压迫开放型打法, 直接去大球",TOTAL GOAL,PRE MATCH,WIN,Tottenham,Southampton
"Over 2.5 @ 2.00

$50.00 Single",2021-04-21 12:13:07,50.0,100.0,50.0,PL,2.0,1688.86,"Tottenham 2:1 Southampton
投注理由: 热刺换帅,  肯定不会再狗了...
南安普顿也是高位压迫开放型打法, 直接去大球",TOTAL GOAL,PRE MATCH,WIN,Tottenham,Southampton
"Getafe -1.0 @ 2.050

$36.95 Single",2021-04-21 19:07:57,36.95,36.95,0.0,La liga,2.05,1688.86,"Getafe vs Barcelona
联赛得牌最多的队对得牌最少的队，结果巴塞黄牌还多点...
结论: card千万别碰",ASIAN HANDICAP,PRE MATCH,CASH_OUT,Barcelona,Getafe
"Shanghai Shenhua @ 3.40

$36.95 Single",2021-04-23 07:47:18,36.95,125.63,88.68,CSL,3.4,1777.54,"申花2:1 国安
实盘追入, 申花实力明显占优, 战术和组织都高一档",FINAL RESULT,LIVE,WIN,Shanghai Shenhua,
"Shanghai Shenhua @ 3.50

$50.00 Single",2021-04-23 08:10:03,50.0,175.0,125.0,CSL,3.5,1902.54,"申花2:1 国安
实盘追入, 申花实力明显占优, 战术和组织都高一档",FINAL RESULT,LIVE,WIN,Shanghai Shenhua,
"Shanghai Shenhua @ 1.95

$50.63 Single",2021-04-23 09:49:29,50.63,98.73,48.1,CSL,1.95,1950.64,"申花2:1 国安
实盘追入, 申花实力明显占优, 战术和组织都高一档",FINAL RESULT,LIVE,WIN,Shanghai Shenhua,
"Everton +0.5 @ 1.890

$50.00 Single",2021-04-23 11:58:59,50.0,94.5,44.5,PL,1.89,1995.14,"Everton 1: 0 Arsenal
投注依据: 拉卡泽特缺阵
阿森纳进攻的阵眼",ASIAN HANDICAP,PRE MATCH,WIN,Arsenal,Everton
"Draw @ 6.00

$24.50 Single",2021-04-24 13:03:45,24.5,0.0,-24.5,PL,6.0,1970.64,West Ham v Chelsea,FINAL RESULT,LIVE,LOST,Chelsea,
"Over 2.5,3.0 @ 1.910

$70.00 Single",2021-04-25 10:20:40,70.0,0.0,-70.0,PL,1.91,1900.64,"Man City 1:0 Tottenham
联赛杯决赛, 热刺换帅，以为不会狗了，会对攻. 结果还是曼城狗
",TOTAL GOAL,PRE MATCH,LOST,Manchester City,Tottenham
"AC Milan 0.0,+0.5 @ 2.000

$100.00 Single",2021-04-26 11:14:18,100.0,0.0,-100.0,Serie A,2.0,1800.64,"Lazio 3: 0 AC Milan
没啥好说的... 意甲这赛季就是坑",ASIAN HANDICAP,PRE MATCH,LOST,Lazio,AC Milan
"AC Milan @ 3.10

$50.00 Single",2021-04-26 11:14:34,50.0,50.0,0.0,Serie A,3.1,1800.64,"Lazio 3: 0 AC Milan
没啥好说的... 意甲这赛季就是坑",FINAL RESULT,PRE MATCH,PUSH,Lazio,AC Milan
"AC Milan or Draw @ 2.62

$50.00 Single",2021-04-26 14:07:52,50.0,0.0,-50.0,Serie A,2.62,1750.64,"Lazio 3: 0 AC Milan
没啥好说的... 意甲这赛季就是坑",FINAL RESULT,LIVE,LOST,Lazio,AC Milan
"Chelsea 0.0,+0.5 @ 1.820

$50.00 Single",2021-04-27 13:07:41,50.0,70.5,20.5,UCL,1.82,1771.14,"Chelsea 1: 1 Real Madrid
这场开场发现皇马马塞洛明显弱点，皇马完全懵圈,
实盘持续追入切尔西.
比赛走势符合判断, 切尔西场面占优且在20分钟左右取得领先
可惜后面皇马缓过气来，没能拿下",ASIAN HANDICAP,PRE MATCH,WIN,Real Madrid,Chelsea
"Chelsea 0.0,+0.5 @ 1.820

$100.00 Single",2021-04-27 13:09:08,100.0,141.0,41.0,UCL,1.82,1812.14,"Chelsea 1: 1 Real Madrid
这场开场发现皇马马塞洛明显弱点，皇马完全懵圈,
实盘持续追入切尔西.
比赛走势符合判断, 切尔西场面占优且在20分钟左右取得领先
可惜后面皇马缓过气来，没能拿下",ASIAN HANDICAP,PRE MATCH,WIN,Real Madrid,Chelsea
"(0-0) Chelsea 0.0 @ 2.060

$100.00 Single",2021-04-27 14:06:31,100.0,100.0,0.0,UCL,2.06,1812.14,"Chelsea 1: 1 Real Madrid
这场开场发现皇马马塞洛明显弱点，皇马完全懵圈,
实盘持续追入切尔西.
比赛走势符合判断, 切尔西场面占优且在20分钟左右取得领先
可惜后面皇马缓过气来，没能拿下",ASIAN HANDICAP,LIVE,PUSH,Real Madrid,Chelsea
"(0-0) Chelsea 0.0 @ 1.890

$100.00 Single",2021-04-27 14:11:36,100.0,100.0,0.0,UCL,1.89,1812.14,"Chelsea 1: 1 Real Madrid
这场开场发现皇马马塞洛明显弱点，皇马完全懵圈,
实盘持续追入切尔西.
比赛走势符合判断, 切尔西场面占优且在20分钟左右取得领先
可惜后面皇马缓过气来，没能拿下",ASIAN HANDICAP,LIVE,PUSH,Real Madrid,Chelsea
"Chelsea to score 2nd goal @ 2.10

$20.00 Single",2021-04-27 14:25:14,20.0,0.0,-20.0,UCL,2.1,1792.14,"Chelsea 1: 1 Real Madrid
这场开场发现皇马马塞洛明显弱点，皇马完全懵圈,
实盘持续追入切尔西.
比赛走势符合判断, 切尔西场面占优且在20分钟左右取得领先
可惜后面皇马缓过气来，没能拿下",TEAM TO SCORE,LIVE,LOST,Real Madrid,Chelsea
"(0-1) Chelsea 0.0 @ 1.850

$100.00 Single",2021-04-27 14:26:22,100.0,0.0,-100.0,UCL,1.85,1692.14,"Chelsea 1: 1 Real Madrid
这场开场发现皇马马塞洛明显弱点，皇马完全懵圈,
实盘持续追入切尔西.
比赛走势符合判断, 切尔西场面占优且在20分钟左右取得领先
可惜后面皇马缓过气来，没能拿下",ASIAN HANDICAP,LIVE,LOST,Real Madrid,Chelsea
"(1-1) Chelsea -0.5 @ 2.675

$80.00 Single",2021-04-27 14:39:50,80.0,0.0,-80.0,UCL,2.675,1612.14,"Chelsea 1: 1 Real Madrid
这场开场发现皇马马塞洛明显弱点，皇马完全懵圈,
实盘持续追入切尔西.
比赛走势符合判断, 切尔西场面占优且在20分钟左右取得领先
可惜后面皇马缓过气来，没能拿下",ASIAN HANDICAP,LIVE,LOST,Real Madrid,Chelsea
"(1-1) Chelsea 0.0 @ 1.675

$100.00 Single",2021-04-27 15:22:40,100.0,100.0,0.0,UCL,1.675,1612.14,"Chelsea 1: 1 Real Madrid
这场开场发现皇马马塞洛明显弱点，皇马完全懵圈,
实盘持续追入切尔西.
比赛走势符合判断, 切尔西场面占优且在20分钟左右取得领先
可惜后面皇马缓过气来，没能拿下",ASIAN HANDICAP,LIVE,PUSH,Real Madrid,Chelsea
"Chelsea @ 3.60

$50.00 Single",2021-04-27 15:23:37,50.0,0.0,-50.0,UCL,3.6,1562.14,"Chelsea 1: 1 Real Madrid
这场开场发现皇马马塞洛明显弱点，皇马完全懵圈,
实盘持续追入切尔西.
比赛走势符合判断, 切尔西场面占优且在20分钟左右取得领先
可惜后面皇马缓过气来，没能拿下",FINAL RESULT,LIVE,LOST,Real Madrid,Chelsea
"No @ 2.10

$61.50 Single",2021-04-27 22:38:21,61.5,0.0,-61.5,UCL,2.1,1500.64,"Man CIty 2:1 Paris SG
Match Notes:
https://www.notion.so/match-notes-938aa441680746cda6913d06e8d9ced0#1c359b6bf3264585a41a74e11df57fc0",BTTS,PRE MATCH,LOST,Manchester City,Paris SG
"Shanghai Haigang -0.5,-1.0 @ 1.925

$50.00 Single",2021-04-28 04:46:51,50.0,96.25,46.25,CSL,1.925,1546.89,"上海申花 3:1 湖北
申花第一场看了, 明显是中超独一档的存在.
这场先丢一球随后逆转
重点关注",ASIAN HANDICAP,PRE MATCH,WIN,Shanghai Shenhua,
"Man City -0.5 @ 2.080

$46.25 Single",2021-04-28 07:26:38,46.25,96.2,49.95,UCL,2.08,1596.84,"Man CIty 2:1 Paris SG
Match Notes:
https://www.notion.so/match-notes-938aa441680746cda6913d06e8d9ced0#1c359b6bf3264585a41a74e11df57fc0",ASIAN HANDICAP,PRE MATCH,WIN,Manchester City,Paris SG
"Shanghai Shenhua @ 9.50

$36.20 Single",2021-04-29 05:18:35,36.2,0.0,-36.2,CSL,9.5,1560.64,"上海申花 3:1 湖北
申花第一场看了, 明显是中超独一档的存在.
这一注属于操作失误",FINAL RESULT,LIVE,LOST,Shanghai Shenhua,
"Shanghai Shenhua to score 4th goal @ 3.10

$60.00 Single",2021-04-29 06:33:11,60.0,186.0,126.0,CSL,3.1,1686.64,"上海申花 3:1 湖北
申花第一场看了, 明显是中超独一档的存在.
这场先丢一球随后逆转
重点关注",TEAM TO SCORE,LIVE,WIN,Shanghai Shenhua,
"Brighton @ 2.00

$64.73 Single",2021-05-01 08:43:38,64.73,64.73,0.0,,2.0,1686.64,"Brighton 2: 0 Leeds
利兹联的比赛拿捏的死死的. 赛前首发没有菲利普斯和拉菲尼亚基本确定白给, 重注收米",FINAL RESULT,PRE MATCH,CASH_OUT,Leeds United,
"Brighton -0.5 @ 2.110

$60.00 Single",2021-05-01 08:43:50,60.0,126.6,66.6,PL,2.11,1753.24,"Brighton 2: 0 Leeds
利兹联的比赛拿捏的死死的. 赛前首发没有菲利普斯和拉菲尼亚基本确定白给, 重注收米",ASIAN HANDICAP,PRE MATCH,WIN,Leeds United,
"Brighton -0.5 @ 2.110

$84.73 Single",2021-05-01 08:44:15,84.73,178.79,94.06,PL,2.11,1847.3,"Brighton 2: 0 Leeds
利兹联的比赛拿捏的死死的. 赛前首发没有菲利普斯和拉菲尼亚基本确定白给, 重注收米",ASIAN HANDICAP,PRE MATCH,WIN,Leeds United,
"Brighton -0.5 @ 2.100

$40.00 Single",2021-05-01 08:50:29,40.0,84.0,44.0,PL,2.1,1891.3,"Brighton 2: 0 Leeds
利兹联的比赛拿捏的死死的. 赛前首发没有菲利普斯和拉菲尼亚基本确定白给, 重注收米",ASIAN HANDICAP,PRE MATCH,WIN,Leeds United,
"Over 2.5 @ 2.20

$39.39 Single",2021-05-01 12:36:05,39.39,0.0,-39.39,PL,2.2,1851.91,Chelsea 2:0 Fulham,TOTAL GOAL,LIVE,LOST,Chelsea,
"Over 2.5,3.0 @ 1.930

$50.00 Single",2021-05-02 11:02:09,50.0,96.5,46.5,,1.93,1898.41,,TOTAL GOAL,PRE MATCH,WIN,,
"Chelsea 0.0,-0.5 @ 1.920

$96.50 Single",2021-05-03 07:16:27,96.5,91.68,-4.82,,1.92,1893.59,,ASIAN HANDICAP,PRE MATCH,CASH_OUT,Chelsea,
"(0-0) Sevilla -1.0 @ 2.200

$50.00 Single",2021-05-03 14:22:53,50.0,0.0,-50.0,,2.2,1843.59,,ASIAN HANDICAP,LIVE,LOST,Sevilla,
"(0-0) Sevilla -0.5 @ 1.990

$50.00 Single",2021-05-03 15:05:37,50.0,0.0,-50.0,,1.99,1793.59,,ASIAN HANDICAP,LIVE,LOST,Sevilla,
"Sevilla @ 3.00

$50.00 Single",2021-05-03 15:33:04,50.0,0.0,-50.0,,3.0,1743.59,,FINAL RESULT,PRE MATCH,LOST,Sevilla,
"Over 2.5 @ 2.37

$50.00 Single",2021-05-04 15:24:18,50.0,0.0,-50.0,,2.37,1693.59,,TOTAL GOAL,PRE MATCH,LOST,,
"Real Madrid 0.0 @ 2.000

$100.00 Single",2021-05-04 22:18:18,100.0,200.0,100.0,UCL,2.0,1793.59,"Chelsea v Real Madrid(Asian Handicap Corners)
欧冠次回合, 皇马需要赢， 这个角球盘很便宜",ASIAN CORNER HANDICAP,PRE MATCH,WIN,Real Madrid,Chelsea
"Shanghai Shenhua @ 5.00

$50.00 Single",2021-05-05 08:15:01,50.0,0.0,-50.0,,5.0,1743.59,,FINAL RESULT,PRE MATCH,LOST,Shanghai Shenhua,
"(0-0) Shanghai Shenhua 0.0 @ 2.750

$100.00 Single",2021-05-05 08:16:32,100.0,100.0,0.0,,2.75,1743.59,,ASIAN HANDICAP,LIVE,PUSH,Shanghai Shenhua,
"(0-0) Shanghai Shenhua 0.0 @ 2.750

$50.00 Single",2021-05-05 08:16:49,50.0,50.0,0.0,,2.75,1743.59,,ASIAN HANDICAP,LIVE,PUSH,Shanghai Shenhua,
"(0-0) Over 1.0 @ 2.350

$100.00 Single",2021-05-05 08:19:31,100.0,235.0,135.0,CSL,2.35,1878.59,"Shanghai Shenhua v Shanghai Haigang (1:1)
上海申花换人调整符合预期, 下半场后半段实盘追入。结果上海申花补时扳平",TOTAL GOAL,LIVE,WIN,Shanghai Shenhua,
"Shanghai Shenhua @ 41.00

$10.00 Single",2021-05-05 08:37:34,10.0,0.0,-10.0,,41.0,1868.59,,FINAL RESULT,PRE MATCH,LOST,Shanghai Shenhua,
"Chelsea 0.0,-0.5 @ 1.940

$75.00 Single",2021-05-05 09:26:21,75.0,145.5,70.5,UCL,1.94,1939.09,"Chelsea v Real Madrid(Asian Handicap)
这个赛季重点关注的切尔西, 防守稳健, 反击能力非常强. 皇马走到半决赛已经是到了极限, 阿扎尔首发基本确定走远",ASIAN HANDICAP,PRE MATCH,WIN,Real Madrid,Chelsea
"No @ 1.95

$100.00 Single",2021-05-05 13:11:25,100.0,195.0,95.0,UCL,1.95,2034.09,"Chelsea v Real Madrid(Asian Handicap)
这个赛季重点关注的切尔西, 防守稳健, 反击能力非常强. 皇马走到半决赛已经是到了极限, 阿扎尔首发基本确定走远",BTTS,PRE MATCH,WIN,Real Madrid,Chelsea
"(1-0) Chelsea 0.0 @ 1.525

$91.68 Single",2021-05-05 15:14:21,91.68,139.82,48.14,UCL,1.525,2082.23,Chelsea v Real Madrid(Alternative Asian Handicap),ASIAN HANDICAP,LIVE,WIN,Real Madrid,Chelsea
"Chelsea +0.5 @ 1.970

$30.32 Single",2021-05-05 20:42:20,30.32,30.32,0.0,,1.97,2082.23,,ASIAN HANDICAP,PRE MATCH,PUSH,Chelsea,
"(0-0) Villarreal 0.0 @ 2.750

$50.00 Single",2021-05-06 14:15:21,50.0,50.0,0.0,,2.75,2082.23,,ASIAN HANDICAP,LIVE,PUSH,Villarreal,
"(0-0) Villarreal +0.5 @ 1.950

$50.00 Single",2021-05-06 14:16:08,50.0,56.02,6.02,,1.95,2088.25,,ASIAN HANDICAP,LIVE,WIN,Villarreal,
"(0-0) Over 0.5 @ 2.070

$36.02 Single",2021-05-06 15:39:06,36.02,0.0,-36.02,,2.07,2052.23,,TOTAL GOAL,LIVE,LOST,,
"Over 2.5,3.0 @ 1.890

$50.32 Single",2021-05-08 06:04:22,50.32,95.11,44.79,PL,1.89,2097.02,"Leeds v Tottenham(3:1)
托特纳姆换帅后打得比较开放, 大球符合预期.
从进球时间分布来看, Leeds下半场后劲十足, 贝尔萨临场调整能力很强, 追入收米",TOTAL GOAL,PRE MATCH,WIN,Leeds United,Tottenham
"(2-1) Leeds 0.0 @ 2.300

$30.00 Single",2021-05-08 07:56:30,30.0,69.0,39.0,PL,2.3,2136.02,"Leeds v Tottenham(3:1)
托特纳姆换帅后打得比较开放, 大球符合预期.
从进球时间分布来看, Leeds下半场后劲十足, 贝尔萨临场调整能力很强, 追入收米",ASIAN HANDICAP,LIVE,WIN,Leeds United,Tottenham
"No @ 2.00

$54.10 Single",2021-05-08 08:54:13,54.1,108.2,54.1,La liga,2.0,2190.12,"Barcelona v Atletico Madrid(0:0)
西甲争冠生死战",BTTS,PRE MATCH,WIN,Barcelona,Atletico Madrid
"Over 0.5 @ 1.61

$30.01 Single",2021-05-08 10:42:06,30.01,0.0,-30.01,,1.61,2160.11,,TOTAL GOAL,PRE MATCH,LOST,,
"Over 0.5 @ 1.90

$20.00 Single",2021-05-08 10:51:12,20.0,0.0,-20.0,,1.9,2140.11,,TOTAL GOAL,PRE MATCH,LOST,,
"Chelsea +0.5 @ 1.860

$138.20 Single",2021-05-08 11:26:11,138.2,257.06,118.86,PL,1.86,2258.97,"Man City v Chelsea(1:2)
欧冠决赛的预演. 瓜迪奥拉替补出战, 打得主意是赢了白得一个心理优势, 输了也可以实验战术, 在欧冠决赛打针对",ASIAN HANDICAP,PRE MATCH,WIN,Chelsea,Manchester City
"Chelsea @ 4.00

$50.00 Single",2021-05-08 11:45:18,50.0,200.0,150.0,PL,4.0,2408.97,"Man City v Chelsea(1:2)
欧冠决赛的预演. 瓜迪奥拉替补出战, 打得主意是赢了白得一个心理优势, 输了也可以实验战术, 在欧冠决赛打针对",FINAL RESULT,PRE MATCH,WIN,Chelsea,Manchester City
"Sevilla +0.5 @ 1.970

$57.06 Single",2021-05-08 16:45:07,57.06,54.21,-2.85,,1.97,2406.12,,ASIAN HANDICAP,PRE MATCH,CASH_OUT,Sevilla,
"Sevilla +0.5 @ 1.970

$50.00 Single",2021-05-08 22:40:50,50.0,98.5,48.5,,1.97,2454.62,,ASIAN HANDICAP,PRE MATCH,WIN,Sevilla,
"No @ 2.10

$30.00 Single",2021-05-09 11:43:38,30.0,0.0,-30.0,La liga,2.1,2424.62,"Real Madrid 2:2 Sevilla
塞维利亚感觉有点提前放弃, 踢的有点假. 这个队和莱比锡红牛一样属于我准备拉黑的队
皇马补时绝平. ",BTTS,PRE MATCH,LOST,Real Madrid,Sevilla
"Under 2.5 @ 2.10

$30.00 Single",2021-05-09 11:43:47,30.0,0.0,-30.0,La liga,2.1,2394.62,"Real Madrid 2:2 Sevilla
塞维利亚感觉有点提前放弃, 踢的有点假. 这个队和莱比锡红牛一样属于我准备拉黑的队
皇马补时绝平. ",TOTAL GOAL,PRE MATCH,LOST,Real Madrid,Sevilla
"Real Madrid to score 4th goal @ 2.75

$34.21 Single",2021-05-09 15:34:35,34.21,94.08,59.87,,2.75,2454.49,"Real Madrid 2:2 Sevilla
塞维利亚感觉有点提前放弃, 踢的有点假. 这个队和莱比锡红牛一样属于我准备拉黑的队
皇马补时绝平. ",TEAM TO SCORE,LIVE,WIN,Real Madrid,Sevilla
"Real Madrid to score 4th goal @ 3.20

$30.00 Single",2021-05-09 15:38:13,30.0,96.0,66.0,,3.2,2520.49,"Real Madrid 2:2 Sevilla
塞维利亚感觉有点提前放弃, 踢的有点假. 这个队和莱比锡红牛一样属于我准备拉黑的队
皇马补时绝平. ",TEAM TO SCORE,LIVE,WIN,Real Madrid,Sevilla
"Shanghai Shenhua -0.5 @ 1.925

$58.58 Single",2021-05-10 04:56:41,58.58,0.0,-58.58,CSL,1.925,2461.91,"Hebei v Shanghai Shenhua(1:1)
申花和赛季初的表现开始有所出入了",ASIAN HANDICAP,PRE MATCH,LOST,Shanghai Shenhua,
"Shanghai Shenhua @ 3.75

$30.00 Single",2021-05-10 06:06:26,30.0,0.0,-30.0,CSL,3.75,2431.91,"Hebei v Shanghai Shenhua(1:1)
申花和赛季初的表现开始有所出入了",FINAL RESULT,PRE MATCH,LOST,Shanghai Shenhua,
"Leicester +0.5 @ 1.850

$130.00 Single",2021-05-11 09:09:22,130.0,130.0,0.0,PL,1.85,2431.91,"Man Utd v Leicester
曼联有欧联任务, 这场全替补放了",ASIAN HANDICAP,PRE MATCH,PUSH,Manchester United,Leichester
"Leicester @ 2.10

$50.00 Single",2021-05-11 11:02:05,50.0,85.91,35.91,PL,2.1,2467.82,"Man Utd v Leicester
曼联有欧联任务, 这场全替补放了",FINAL RESULT,PRE MATCH,WIN,Manchester United,Leichester
"Leicester +0.5 @ 1.850

$100.00 Single",2021-05-11 11:02:25,100.0,185.0,85.0,PL,1.85,2552.82,"Man Utd v Leicester
曼联有欧联任务, 这场全替补放了",ASIAN HANDICAP,PRE MATCH,WIN,Manchester United,Leichester
"Liverpool 0.0 @ 1.810

$80.91 Single",2021-05-11 15:52:22,80.91,146.45,65.54,PL,1.81,2618.36,"Man Utd v Liverpool(2:4)
曼联有欧联任务, 利物浦心无旁骛
马奎尔不能踢",ASIAN HANDICAP,PRE MATCH,WIN,Liverpool,Manchester United
"Liverpool 0.0,-0.5 @ 2.125

$70.00 Single",2021-05-12 21:25:59,70.0,148.75,78.75,PL,2.125,2697.11,"Man Utd v Liverpool(2:4)
曼联有欧联任务, 利物浦心无旁骛
马奎尔不能踢",ASIAN HANDICAP,PRE MATCH,WIN,Liverpool,Manchester United
"Over 3.0 @ 2.070

$65.20 Single",2021-05-15 05:56:42,65.2,134.97,69.77,PL,2.07,2766.88,Burnley v Leeds(Goal Line),TOTAL GOAL,PRE MATCH,WIN,Leeds United,
"Yes @ 1.90

$30.00 Single",2021-05-15 07:38:42,30.0,0.0,-30.0,,1.9,2736.88,,BTTS,PRE MATCH,LOST,,
"Chelsea -0.5 @ 2.050

$64.97 Single",2021-05-15 09:09:22,64.97,0.0,-64.97,,2.05,2671.91,Chelsea v Leicester(Asian Handicap),ASIAN HANDICAP,PRE MATCH,LOST,Chelsea,Leichester
"Inter Milan @ 3.30

$50.00 Single",2021-05-15 10:10:04,50.0,0.0,-50.0,,3.3,2621.91,,FINAL RESULT,PRE MATCH,LOST,Inter,
"(0-0) Liverpool -2.0 @ 2.075

$70.00 Single",2021-05-16 10:39:51,70.0,0.0,-70.0,PL,2.075,2551.91,经典时刻：Liverpool 补时阿利松绝杀降级队,ASIAN HANDICAP,LIVE,LOST,Liverpool,
"Shanghai Shenhua 0.0,-0.5 @ 1.925

$150.00 Single",2021-05-17 06:27:39,150.0,0.0,-150.0,CSL,1.925,2401.91,"国家队集训，国脚提前离队.
但是输球任然是比较意外...开始坑爹了",ASIAN HANDICAP,PRE MATCH,LOST,Shanghai Shenhua,
"(0-0) Shanghai Shenhua -0.5 @ 2.850

$100.00 Single",2021-05-17 08:14:30,100.0,0.0,-100.0,CSL,2.85,2301.91,,ASIAN HANDICAP,LIVE,LOST,Shanghai Shenhua,
"(0-0) Shanghai Shenhua 0.0,-0.5 @ 2.300

$100.00 Single",2021-05-17 08:14:42,100.0,0.0,-100.0,CSL,2.3,2201.91,,ASIAN HANDICAP,LIVE,LOST,Shanghai Shenhua,
"Chelsea -0.5,-1.0 @ 1.940

$100.00 Single",2021-05-17 22:28:31,100.0,147.0,47.0,,1.94,2248.91,,ASIAN HANDICAP,PRE MATCH,WIN,Chelsea,
"Leeds 0.0 @ 1.975

$100.00 Single",2021-05-17 22:29:07,100.0,100.0,0.0,,1.975,2248.91,"Southampton v Leeds(0:2)
无欲无求的两队，没打出大球颇为意外",ASIAN HANDICAP,PRE MATCH,PUSH,Leeds United,Southampton
"Over 3.0 @ 1.830

$100.00 Single",2021-05-18 07:19:12,100.0,0.0,-100.0,PL,1.83,2148.91,"Southampton v Leeds(0:2)
无欲无求的两队，没打出大球颇为意外",TOTAL GOAL,PRE MATCH,LOST,Leeds United,Southampton
"Over 3.0 @ 1.960

$100.00 Single",2021-05-18 11:18:38,100.0,0.0,-100.0,PL,1.96,2048.91,"Southampton v Leeds(0:2)
无欲无求的两队，没打出大球颇为意外",TOTAL GOAL,PRE MATCH,LOST,Leeds United,Southampton
"Chelsea -0.5,-1.0 @ 1.980

$100.00 Single",2021-05-18 13:34:53,100.0,149.0,49.0,,1.98,2097.91,"Chelsea v Leicester(2:1)
欧冠资格生死战, 切尔西技高一筹, 拿捏的死死的
莱斯特主要的问题是瓦尔迪状态下滑, 阵眼巴恩斯长期伤缺",ASIAN HANDICAP,PRE MATCH,WIN,Chelsea,Leichester
"Chelsea -0.5,-1.0 @ 1.980

$200.00 Single",2021-05-18 13:35:02,200.0,298.0,98.0,PL,1.98,2195.91,"Chelsea v Leicester(2:1)
欧冠资格生死战, 切尔西技高一筹, 拿捏的死死的
莱斯特主要的问题是瓦尔迪状态下滑, 阵眼巴恩斯长期伤缺",ASIAN HANDICAP,PRE MATCH,WIN,Chelsea,Leichester
"Chelsea -0.5,-1.0 @ 1.950

$200.00 Single",2021-05-18 13:55:48,200.0,295.0,95.0,PL,1.95,2290.91,"Chelsea v Leicester(2:1)
欧冠资格生死战, 切尔西技高一筹, 拿捏的死死的
莱斯特主要的问题是瓦尔迪状态下滑, 阵眼巴恩斯长期伤缺",ASIAN HANDICAP,PRE MATCH,WIN,Chelsea,Leichester
"(1-0) Chelsea 0.0,-0.5 @ 1.820

$100.00 Single",2021-05-18 15:23:58,100.0,50.0,-50.0,PL,1.82,2240.91,"Chelsea v Leicester(2:1)
欧冠资格生死战, 切尔西技高一筹, 拿捏的死死的
莱斯特主要的问题是瓦尔迪状态下滑, 阵眼巴恩斯长期伤缺",ASIAN HANDICAP,LIVE,LOST,Chelsea,Leichester
"Timo Werner (Anytime) @ 4.33

$20.00 Single",2021-05-18 15:25:16,20.0,0.0,-20.0,PL,4.33,2220.91,"维尔纳进球, 娱乐~~",FINAL RESULT,PRE MATCH,LOST,,
"Newcastle -0.5,-1.0 @ 1.980

$119.00 Single",2021-05-18 21:37:16,119.0,177.31,58.31,PL,1.98,2279.22,"Newcastle 1:0 降级队
主场有观众，newcastle踢的还是心不在焉
",ASIAN HANDICAP,PRE MATCH,WIN,Newcastle,
"Everton -0.5 @ 1.900

$100.00 Single",2021-05-18 21:48:28,100.0,190.0,90.0,PL,1.9,2369.22,,ASIAN HANDICAP,PRE MATCH,WIN,Everton,
"Newcastle -0.5 @ 1.900

$100.00 Single",2021-05-19 11:14:25,100.0,161.22,61.22,PL,1.9,2430.44,"Newcastle 1:0 降级队
主场有观众，newcastle踢的还是心不在焉
求稳妥只能early cashout",ASIAN HANDICAP,PRE MATCH,WIN,Newcastle,
"Newcastle -0.5 @ 1.910

$100.00 Single",2021-05-19 11:15:22,100.0,161.16,61.16,PL,1.91,2491.6,"Newcastle 1:0 降级队
主场有观众，newcastle踢的还是心不在焉
求稳妥只能early cashout",ASIAN HANDICAP,PRE MATCH,WIN,Newcastle,
"Atalanta @ 2.25

$89.69 Single",2021-05-19 14:08:42,89.69,0.0,-89.69,Serie A,2.25,2401.91,"Atalanta v Juventus(Fulltime Result)
意大利杯决赛, 亚特兰大这队伍基本已经垮了
这个赛季戈麦斯转会, 伊利西奇状态断崖式下滑",FINAL RESULT,PRE MATCH,LOST,Juventus,Atalanta
"(0-0) Over 3.0 @ 1.750

$100.00 Single",2021-05-19 14:27:18,100.0,100.0,0.0,,1.75,2401.91,,TOTAL GOAL,LIVE,PUSH,,
"AC Milan 0.0 @ 1.910

$100.00 Single",2021-05-20 10:02:07,100.0,92.05,-7.95,Serie A,1.91,2393.96,Atalanta 1:3 AC Milan(Asian Handicap),ASIAN HANDICAP,PRE MATCH,CASH_OUT,Atalanta,AC Milan
"No @ 2.20

$50.00 Single",2021-05-22 09:46:40,50.0,0.0,-50.0,La liga,2.2,2343.96,"Real Madrid 2:1 Villarreal(Both Teams to Score)
西甲最后一轮, 本场涉及争冠, 详细分析:
https://www.notion.so/2021-final-round-summary-b1caa6c995a64e639e2fcde5f110e9c9",BTTS,PRE MATCH,LOST,Real Madrid,Villarreal
"Under 2.5 @ 2.75

$50.00 Single",2021-05-22 09:47:04,50.0,0.0,-50.0,La liga,2.75,2293.96,"Real Madrid v Villarreal(Total Goals)
https://www.notion.so/2021-final-round-summary-b1caa6c995a64e639e2fcde5f110e9c9",TOTAL GOAL,PRE MATCH,LOST,Real Madrid,Villarreal
"AC Milan 0.0 @ 2.070

$100.00 Single",2021-05-22 09:55:19,100.0,207.0,107.0,Serie A,2.07,2400.96,"Atalanta 1:3  AC Milan(Asian Handicap)
末轮欧冠资格战, 故事很多.
详细分析: https://www.notion.so/2021-final-round-summary-b1caa6c995a64e639e2fcde5f110e9c9",ASIAN HANDICAP,PRE MATCH,WIN,Atalanta,AC Milan
"AC Milan 0.0 @ 2.070

$100.00 Single",2021-05-22 09:55:28,100.0,207.0,107.0,Serie A,2.07,2507.96,"Atalanta 1:3  AC Milan(Asian Handicap)
末轮欧冠资格战, 故事很多.
详细分析: https://www.notion.so/2021-final-round-summary-b1caa6c995a64e639e2fcde5f110e9c9",ASIAN HANDICAP,PRE MATCH,WIN,Atalanta,AC Milan
"Man Utd -0.5 @ 1.910

$100.00 Single",2021-05-22 13:05:53,100.0,95.0,-5.0,UCL,1.91,2502.96,,ASIAN HANDICAP,PRE MATCH,CASH_OUT,Manchester United,
"Leeds -1.0 @ 1.930

$100.00 Single",2021-05-23 09:20:29,100.0,193.0,93.0,PL,1.93,2595.96,"Leeds v West Brom(3:1)
联赛最后一轮，2队都无欲无求, 利兹联主场也是唯一一个有球迷入场的主场, 考虑到这一点还是信了一手
本赛季leeds圆满收官",ASIAN HANDICAP,PRE MATCH,WIN,Leeds United,
"Over 3.0 @ 1.950

$100.00 Single",2021-05-23 09:21:06,100.0,195.0,95.0,PL,1.95,2690.96,Leicester v Tottenham(Goal Line),TOTAL GOAL,PRE MATCH,WIN,Leichester,Tottenham
"AC Milan 0.0 @ 2.050

$88.00 Single",2021-05-23 12:21:02,88.0,83.6,-4.4,Serie A,2.05,2686.56,,ASIAN HANDICAP,PRE MATCH,CASH_OUT,AC Milan,
"Juventus -1.5,-2.0 @ 1.980

$200.00 Single",2021-05-23 13:11:46,200.0,200.0,0.0,Serie A,1.98,2686.56,,ASIAN HANDICAP,PRE MATCH,CASH_OUT,Juventus,
"Juventus -2.0 @ 1.900

$100.00 Single",2021-05-23 13:12:24,100.0,0.0,-100.0,Serie A,1.9,2586.56,"尤文欧冠生死战, C罗终于被拿下, 早早领先后开始划水, 最后居然是0角球, 无语
https://www.notion.so/2021-final-round-summary-b1caa6c995a64e639e2fcde5f110e9c9",ASIAN CORNER HANDICAP,PRE MATCH,LOST,Juventus,
"Juventus -2.0 @ 1.900

$100.00 Single",2021-05-23 13:12:37,100.0,0.0,-100.0,Serie A,1.9,2486.56,"尤文欧冠生死战, C罗终于被拿下, 早早领先后开始划水, 最后居然是0角球, 无语
https://www.notion.so/2021-final-round-summary-b1caa6c995a64e639e2fcde5f110e9c9",ASIAN CORNER HANDICAP,PRE MATCH,LOST,Juventus,
"(0-1) AC Milan 0.0 @ 2.375

$75.65 Single",2021-05-23 15:25:45,75.65,179.67,104.02,Serie A,2.375,2590.58,,ASIAN HANDICAP,LIVE,WIN,AC Milan,
"Chelsea @ 4.33

$43.67 Single",2021-05-24 21:09:48,43.67,189.24,145.57,UCL,4.33,2736.15,,FINAL RESULT,PRE MATCH,WIN,Chelsea,
"(0-0) Man Utd -0.5 @ 1.970

$100.00 Single",2021-05-26 14:21:29,100.0,0.0,-100.0,UCL,1.97,2636.15,"Villarreal v Man Utd(1:1)  Villarreal win in penalty shoot out
欧联杯决赛, 曼联踢的有点可疑: 90分钟不换人, 拉师傅和格林伍德踢的很差, 不正常的差
投注纪律: 这种鸡肋杯赛的决赛尽量少碰英超的热门球队",ASIAN HANDICAP,LIVE,LOST,Manchester United,Villarreal
"(0-0) Man Utd -0.5 @ 1.970

$145.00 Single",2021-05-26 14:22:07,145.0,0.0,-145.0,UCL,1.97,2491.15,"Villarreal v Man Utd(1:1)  Villarreal win in penalty shoot out
欧联杯决赛, 曼联踢的有点可疑: 90分钟不换人, 拉师傅和格林伍德踢的很差, 不正常的差
投注纪律: 这种鸡肋杯赛的决赛尽量少碰英超的热门球队",ASIAN HANDICAP,LIVE,LOST,Manchester United,Villarreal
"Chelsea +2.0 @ 1.900

$300.00 Single",2021-05-27 22:13:29,300.0,300.0,0.0,UCL,1.9,2491.15,"Man City v Chelsea(0:1)
欧冠决赛, 瓜迪奥拉心魔难除. 我现在越来越理解他的想法了. 想在战术上做到极致, 在战术上讨到便宜. 但是球员的执行力和理解程度未能如意. 这样有时还不如踢一个中庸的战术, 靠球员的能力解决问题",ASIAN HANDICAP,PRE MATCH,CASH_OUT,Chelsea,Manchester City
"Chelsea +0.5 @ 2.010

$100.00 Single",2021-05-27 22:13:48,100.0,201.0,101.0,UCL,2.01,2592.15,"Man City v Chelsea(0:1)
欧冠决赛, 瓜迪奥拉心魔难除. 我现在越来越理解他的想法了. 想在战术上做到极致, 在战术上讨到便宜. 但是球员的执行力和理解程度未能如意. 这样有时还不如踢一个中庸的战术, 靠球员的能力解决问题",ASIAN HANDICAP,PRE MATCH,WIN,Chelsea,Manchester City
"Chelsea @ 4.70

$100.00 Single",2021-05-27 22:14:01,100.0,470.0,370.0,UCL,4.7,2962.15,"Man City v Chelsea(0:1)
欧冠决赛, 瓜迪奥拉心魔难除. 我现在越来越理解他的想法了. 想在战术上做到极致, 在战术上讨到便宜. 但是球员的执行力和理解程度未能如意. 这样有时还不如踢一个中庸的战术, 靠球员的能力解决问题",FINAL RESULT,PRE MATCH,WIN,Chelsea,Manchester City
"Chelsea +2.0 @ 1.900

$100.00 Single",2021-05-28 12:20:52,100.0,100.0,0.0,UCL,1.9,2962.15,"Man City v Chelsea(0:1)
欧冠决赛, 瓜迪奥拉心魔难除. 我现在越来越理解他的想法了. 想在战术上做到极致, 在战术上讨到便宜. 但是球员的执行力和理解程度未能如意. 这样有时还不如踢一个中庸的战术, 靠球员的能力解决问题",ASIAN CORNER HANDICAP,PRE MATCH,PUSH,Chelsea,Manchester City
"Chelsea 3-2 @ 41.00

$20.00 Single",2021-05-29 13:21:15,20.0,0.0,-20.0,UCL,41.0,2942.15,梦见这个比分，必须走一手,FINAL SCORE,PRE MATCH,LOST,Chelsea,
"Turkey @ 8.50

($30.00 Bet Credits)",2021-06-11 13:09:18,30.0,0.0,-30.0,EURO,8.5,2912.15,,FINAL RESULT,PRE MATCH,LOST,,
"Quincy Crew @ 1.72

$50.00 Single",2021-06-12 07:07:00,50.0,0.0,-50.0,TI,1.72,2862.15,,FINAL RESULT,PRE MATCH,LOST,,
"Quincy Crew @ 2.25

$20.00 Single",2021-06-12 07:43:46,20.0,0.0,-20.0,TI,2.25,2842.15,,FINAL RESULT,PRE MATCH,LOST,,
"(0-0) Under 1.0 @ 2.100

$50.00 Single",2021-06-12 13:47:18,50.0,50.0,0.0,EURO,2.1,2842.15,,TOTAL GOAL,LIVE,PUSH,,
"Belgium -1.5 @ 1.975

$100.00 Single",2021-06-12 13:53:34,100.0,0.0,-100.0,EURO,1.975,2742.15,"Belgium vs Russia (3:0)
小组赛大坑, 角球是真的不稳",ASIAN CORNER HANDICAP,PRE MATCH,LOST,,
"Belgium -1.5 @ 1.975

$100.00 Single",2021-06-12 13:53:42,100.0,0.0,-100.0,EURO,1.975,2642.15,"Belgium vs Russia (3:0)
小组赛大坑, 角球是真的不稳",ASIAN CORNER HANDICAP,PRE MATCH,LOST,,
"England -1.0 @ 1.980

$100.00 Single",2021-06-13 07:59:09,100.0,100.0,0.0,EURO,1.98,2642.15,"England vs Crotia 1:0
英格兰初显冠军相",ASIAN HANDICAP,PRE MATCH,PUSH,,
"England -1.0 @ 1.980

$100.00 Single",2021-06-13 07:59:22,100.0,100.0,0.0,EURO,1.98,2642.15,"England vs Crotia 1:0
英格兰初显冠军相",ASIAN HANDICAP,PRE MATCH,PUSH,,
"(1-0) England -0.5 @ 4.250

$20.00 Single",2021-06-13 09:39:28,20.0,0.0,-20.0,EURO,4.25,2622.15,"England vs Crotia 1:0
滚球盘, 风险控制得当",ASIAN HANDICAP,LIVE,LOST,,
"(0-0) Over 0.5 @ 1.825

$20.00 Single",2021-06-13 14:23:40,20.0,0.0,-20.0,EURO,1.825,2602.15,,TOTAL GOAL,LIVE,LOST,,
"Slovakia @ 5.75

$10.00 Single",2021-06-14 10:57:08,10.0,57.5,47.5,EURO,5.75,2649.65,,FINAL RESULT,PRE MATCH,WIN,,
"(0-1) Slovakia 0.0 @ 3.350

$20.00 Single",2021-06-14 11:34:13,20.0,20.0,0.0,EURO,3.35,2649.65,,ASIAN HANDICAP,LIVE,PUSH,,
"Over 2.5 @ 1.970

$17.50 Single",2021-06-14 13:17:53,17.5,0.0,-17.5,EURO,1.97,2632.15,,TOTAL GOAL,PRE MATCH,LOST,,
"(0-0) Spain -1.0,-1.5 @ 1.860

$40.00 Single",2021-06-14 14:10:03,40.0,0.0,-40.0,EURO,1.86,2592.15,"Spain vs Sweden 0:0
西班牙超级大坑. 这场初盘都没上, 开场打了一会才确认下注西班牙. 这样都没防住, 无话可说
主要的问题是追上头了~~",ASIAN HANDICAP,LIVE,LOST,,
"(0-0) Over 1.5 @ 2.010

$50.00 Single",2021-06-14 15:06:31,50.0,0.0,-50.0,EURO,2.01,2542.15,"Spain vs Sweden 0:0
西班牙超级大坑. 这场初盘都没上, 开场打了一会才确认下注西班牙. 这样都没防住, 无话可说
主要的问题是追上头了~~",TOTAL GOAL,LIVE,LOST,,
"(0-0) Spain -0.5 @ 2.300

$100.00 Single",2021-06-14 15:31:13,100.0,0.0,-100.0,EURO,2.3,2442.15,"Spain vs Sweden 0:0
西班牙超级大坑. 这场初盘都没上, 开场打了一会才确认下注西班牙. 这样都没防住, 无话可说
主要的问题是追上头了~~",ASIAN HANDICAP,LIVE,LOST,,
"Spain @ 2.50

$100.00 Single",2021-06-14 15:35:42,100.0,0.0,-100.0,EURO,2.5,2342.15,"Spain vs Sweden 0:0
西班牙超级大坑. 这场初盘都没上, 开场打了一会才确认下注西班牙. 这样都没防住, 无话可说
主要的问题是追上头了~~",FINAL RESULT,LIVE,LOST,,
"Hungary @ 8.50

$10.00 Single",2021-06-15 10:48:00,10.0,0.0,-10.0,EURO,8.5,2332.15,,FINAL RESULT,PRE MATCH,LOST,,
"(1-0) Germany -0.5 @ 3.350

$90.00 Single",2021-06-15 15:31:07,90.0,0.0,-90.0,EURO,3.35,2242.15,,ASIAN HANDICAP,LIVE,LOST,,
"Russia -3.0 @ 1.800

$20.00 Single",2021-06-16 07:51:01,20.0,20.0,0.0,EURO,1.8,2242.15,,ASIAN HANDICAP,PRE MATCH,PUSH,,
"Turkey 0.0 @ 1.940

$20.00 Single",2021-06-16 10:08:55,20.0,0.0,-20.0,EURO,1.94,2222.15,,ASIAN HANDICAP,PRE MATCH,LOST,,
"Switzerland +0.5,+1.0 @ 1.930

$20.00 Single",2021-06-16 13:03:27,20.0,0.0,-20.0,EURO,1.93,2202.15,,ASIAN HANDICAP,PRE MATCH,LOST,,
"Denmark @ 4.20

$20.00 Single",2021-06-16 22:14:27,20.0,50.4,30.4,EURO,4.2,2232.55,,FINAL RESULT,PRE MATCH,WIN,,
"Netherlands -1.0 @ 2.020

$20.00 Single",2021-06-16 23:26:36,20.0,40.4,20.4,EURO,2.02,2252.95,,ASIAN HANDICAP,PRE MATCH,WIN,,
"(1-1) Over 3.0 @ 2.110

$50.00 Single",2021-06-17 12:13:53,50.0,72.26,22.26,EURO,2.11,2275.21,,TOTAL GOAL,LIVE,WIN,,
"(1-0) Netherlands -0.5 @ 2.200

$12.66 Single",2021-06-17 15:14:59,12.66,27.86,15.2,EURO,2.2,2290.41,,ASIAN HANDICAP,LIVE,WIN,,
"(1-0) Netherlands -0.5 @ 2.300

$10.00 Single",2021-06-17 15:21:51,10.0,23.0,13.0,EURO,2.3,2303.41,,ASIAN HANDICAP,LIVE,WIN,,
"Slovakia +0.5 @ 2.030

$20.86 Single",2021-06-17 17:42:40,20.86,0.0,-20.86,EURO,2.03,2282.55,,ASIAN HANDICAP,PRE MATCH,LOST,,
"Under 2.0 @ 1.950

$20.00 Single",2021-06-18 07:48:24,20.0,39.0,19.0,EURO,1.95,2301.55,,TOTAL GOAL,PRE MATCH,WIN,,
"Croatia -0.5 @ 2.025

$40.40 Single",2021-06-18 09:56:18,40.4,0.0,-40.4,EURO,2.025,2261.15,,ASIAN HANDICAP,PRE MATCH,LOST,,
"Croatia -0.5 @ 2.025

$19.00 Single",2021-06-18 10:01:13,19.0,0.0,-19.0,EURO,2.025,2242.15,,ASIAN HANDICAP,PRE MATCH,LOST,,
"(0-0) England -0.5 @ 2.650

$22.60 Single",2021-06-18 15:30:25,22.6,0.0,-22.6,EURO,2.65,2219.55,,ASIAN HANDICAP,LIVE,LOST,,
"(0-0) England -0.5 @ 2.650

$17.40 Single",2021-06-18 15:30:59,17.4,0.0,-17.4,EURO,2.65,2202.15,,ASIAN HANDICAP,LIVE,LOST,,
"Germany 0.0,-0.5 @ 2.020

$20.00 Single",2021-06-18 20:04:48,20.0,40.4,20.4,EURO,2.02,2222.55,,ASIAN HANDICAP,PRE MATCH,WIN,,
"Spain -1.5 @ 2.040

$20.00 Single",2021-06-19 12:55:36,20.0,0.0,-20.0,EURO,2.04,2202.55,,ASIAN HANDICAP,PRE MATCH,LOST,,
"(0-0) Spain -1.5 @ 1.970

$10.40 Single",2021-06-19 14:00:04,10.4,0.0,-10.4,EURO,1.97,2192.15,,ASIAN HANDICAP,LIVE,LOST,,
"(1-1) Spain -1.0 @ 4.500

$20.00 Single",2021-06-19 15:29:57,20.0,0.0,-20.0,EURO,4.5,2172.15,,ASIAN HANDICAP,LIVE,LOST,,
"Over 2.5,3.0 @ 1.910

$30.00 Single",2021-06-20 09:56:24,30.0,57.3,27.3,EURO,1.91,2199.45,,TOTAL GOAL,PRE MATCH,WIN,,
"Draw @ 3.40

$20.00 Single",2021-06-20 11:19:42,20.0,0.0,-20.0,EURO,3.4,2179.45,,FINAL RESULT,PRE MATCH,LOST,,
"Ukraine 0.0 @ 1.920

$37.30 Single",2021-06-20 19:10:35,37.3,0.0,-37.3,EURO,1.92,2142.15,,ASIAN HANDICAP,PRE MATCH,LOST,,
"Denmark -0.5,-1.0 @ 1.980

$50.00 Single",2021-06-20 19:11:59,50.0,99.0,49.0,EURO,1.98,2191.15,,ASIAN HANDICAP,PRE MATCH,WIN,,
"Ukraine 0.0 @ 2.125

$20.00 Single",2021-06-21 10:52:53,20.0,0.0,-20.0,EURO,2.125,2171.15,,ASIAN HANDICAP,PRE MATCH,LOST,,
"(0-1) Ukraine 0.0 @ 1.950

$30.00 Single",2021-06-21 12:26:59,30.0,30.0,0.0,EURO,1.95,2171.15,,ASIAN HANDICAP,LIVE,PUSH,,
"Denmark -0.5,-1.0 @ 1.890

$30.00 Single",2021-06-21 12:56:54,30.0,56.7,26.7,EURO,1.89,2197.85,,ASIAN HANDICAP,PRE MATCH,WIN,,
"Finland @ 11.00

$10.00 Single",2021-06-21 15:03:01,10.0,0.0,-10.0,EURO,11.0,2187.85,,FINAL RESULT,PRE MATCH,LOST,,
"Finland @ 67.00

$10.00 Single",2021-06-21 15:31:30,10.0,0.0,-10.0,EURO,67.0,2177.85,,FINAL RESULT,PRE MATCH,LOST,,
"Draw @ 3.75

$35.70 Single",2021-06-22 13:29:50,35.7,35.7,0.0,EURO,3.75,2177.85,,FINAL RESULT,PRE MATCH,PUSH,,
"England 1-0 @ 7.50

$10.00 Single",2021-06-22 13:36:11,10.0,28.58,18.58,EURO,7.5,2196.43,,FINAL SCORE,PRE MATCH,WIN,,
"England 2-0 @ 7.50


$10.00 Single",2021-06-22 13:36:19,10.0,0.0,-10.0,EURO,7.5,2186.43,,FINAL SCORE,PRE MATCH,LOST,,
"Scotland 0.0 @ 2.000

$15.70 Single",2021-06-22 13:49:02,15.7,0.0,-15.7,EURO,2.0,2170.73,,ASIAN HANDICAP,PRE MATCH,LOST,,
"France 0.0,-0.5 @ 1.910

$28.58 Single",2021-06-22 15:58:17,28.58,14.29,-14.29,EURO,1.91,2156.44,"France vs Portugal (2:2)
法国也是老演员了
打平输一半",ASIAN HANDICAP,PRE MATCH,LOST,,
"France 0.0,-0.5 @ 1.900

$200.00 Single",2021-06-22 16:02:52,200.0,100.0,-100.0,EURO,1.9,2056.44,"France vs Portugal (2:2)
法国也是老演员了
打平输一半",ASIAN HANDICAP,PRE MATCH,LOST,,
"Portugal 1-0 @ 11.00


$10.00 Single",2021-06-23 08:01:03,10.0,0.0,-10.0,EURO,11.0,2046.44,,FINAL SCORE,PRE MATCH,LOST,,
"Portugal 2-1 @ 15.00


$10.00 Single",2021-06-23 08:01:17,10.0,0.0,-10.0,EURO,15.0,2036.44,,FINAL SCORE,PRE MATCH,LOST,,
"Sweden 0.0 @ 2.060

$30.00 Single",2021-06-23 09:36:56,30.0,51.33,21.33,EURO,2.06,2057.77,,ASIAN HANDICAP,PRE MATCH,WIN,,
"France -0.5 @ 1.960

$51.33 Single",2021-06-23 13:06:41,51.33,23.22,-28.11,EURO,1.96,2029.66,,ASIAN HANDICAP,PRE MATCH,LOST,,
"France -0.5 @ 2.010

$50.00 Single",2021-06-23 13:53:19,50.0,23.2,-26.8,EURO,2.01,2002.86,,ASIAN HANDICAP,PRE MATCH,LOST,,
"Belgium 0.0,-0.5 @ 2.100

$60.71 Single",2021-06-24 17:26:49,60.71,60.71,0.0,EURO,2.1,2002.86,,ASIAN HANDICAP,PRE MATCH,PUSH,,
"Holland -0.5,-1.0 @ 1.890

$50.00 Single",2021-06-24 17:27:25,50.0,0.0,-50.0,EURO,1.89,1952.86,,ASIAN HANDICAP,PRE MATCH,LOST,,
"Belgium 0.0,-0.5 @ 2.090

$110.71 Single",2021-06-25 10:49:40,110.71,231.39,120.68,EURO,2.09,2073.54,,ASIAN HANDICAP,PRE MATCH,WIN,,
"Denmark -0.5 @ 1.910

$50.00 Single",2021-06-26 09:09:13,50.0,95.5,45.5,EURO,1.91,2119.04,,ASIAN HANDICAP,PRE MATCH,WIN,,
"(0-0) Italy -1.0 @ 2.100

$45.50 Single",2021-06-26 13:48:58,45.5,45.5,0.0,EURO,2.1,2119.04,,ASIAN HANDICAP,LIVE,PUSH,,
"(0-0) Italy -1.0 @ 2.100

$35.50 Single",2021-06-26 13:53:04,35.5,0.0,-35.5,EURO,2.1,2083.54,,ASIAN HANDICAP,LIVE,LOST,,
"(0-0) Italy -0.5 @ 2.750

$10.00 Single",2021-06-26 14:16:52,10.0,0.0,-10.0,EURO,2.75,2073.54,,ASIAN HANDICAP,LIVE,LOST,,
"(0-0) Italy -0.5 @ 2.500

$20.00 Single",2021-06-26 15:27:04,20.0,0.0,-20.0,EURO,2.5,2053.54,,ASIAN HANDICAP,LIVE,LOST,,
"(0-0) Italy -0.5 @ 4.000

$20.00 Single",2021-06-26 15:41:51,20.0,0.0,-20.0,EURO,4.0,2033.54,,ASIAN HANDICAP,LIVE,LOST,,
"Italy @ 2.40

$10.00 Single",2021-06-26 15:55:32,10.0,24.0,14.0,EURO,2.4,2047.54,,FINAL RESULT,PRE MATCH,WIN,,
"Italy @ 2.40

$50.00 Single",2021-06-26 15:56:59,50.0,120.0,70.0,EURO,2.4,2117.54,,FINAL RESULT,PRE MATCH,WIN,,
"Italy to score 2nd goal @ 2.20

$20.00 Single",2021-06-26 16:05:46,20.0,44.0,24.0,EURO,2.2,2141.54,,TEAM TO SCORE,LIVE,WIN,,
"Over 2.5 @ 1.83

$24.00 Single",2021-06-26 16:21:14,24.0,44.0,20.0,EURO,1.83,2161.54,,TOTAL GOAL,PRE MATCH,WIN,,
"Belgium 0.0,-0.5 @ 2.150

$88.00 Single",2021-06-27 05:01:58,88.0,189.2,101.2,EURO,2.15,2262.74,"Belgium vs Portugal (1:0)
https://www.notion.so/Euro2020-Knockout-stage-de33691b1052438e8bdf46c40dd25690#98688a7934f24a7e9f5a43c3a61963da",ASIAN HANDICAP,PRE MATCH,WIN,,
"(0-0) Belgium 0.0,-0.5 @ 2.090

$100.00 Single",2021-06-27 13:55:58,100.0,209.0,109.0,EURO,2.09,2371.74,"Belgium vs Portugal (1:0)
https://www.notion.so/Euro2020-Knockout-stage-de33691b1052438e8bdf46c40dd25690#98688a7934f24a7e9f5a43c3a61963da",ASIAN HANDICAP,LIVE,WIN,,
"(1-0) Portugal 0.0 @ 1.700

$100.00 Single",2021-06-27 15:23:20,100.0,100.0,0.0,EURO,1.7,2371.74,"Belgium vs Portugal (1:0)
根据场上形势追滚球平手盘追求安全边际
",ASIAN HANDICAP,LIVE,PUSH,,
"(1-0) Portugal 0.0 @ 1.720

$50.00 Single",2021-06-27 15:38:34,50.0,50.0,0.0,EURO,1.72,2371.74,"Belgium vs Portugal (1:0)
根据场上形势追滚球平手盘追求安全边际
",ASIAN HANDICAP,LIVE,PUSH,,
"England 0.0 @ 1.830

$29.59 Single",2021-06-27 20:29:07,29.59,29.59,0.0,EURO,1.83,2371.74,,ASIAN HANDICAP,PRE MATCH,PUSH,,
"Sweden 0.0,-0.5 @ 2.080

$50.00 Single",2021-06-27 20:29:43,50.0,25.0,-25.0,EURO,2.08,2346.74,,ASIAN HANDICAP,PRE MATCH,LOST,,
"(1-2) Over 3.5 @ 1.820

$20.00 Single",2021-06-28 12:31:08,20.0,36.4,16.4,EURO,1.82,2363.14,,TOTAL GOAL,LIVE,WIN,,
"(0-1) Under 2.0 @ 3.250

$20.00 Single",2021-06-28 15:09:28,20.0,0.0,-20.0,EURO,3.25,2343.14,,TOTAL GOAL,LIVE,LOST,,
"England 0.0 @ 1.820

$46.40 Single",2021-06-28 19:17:58,46.4,46.4,0.0,EURO,1.82,2343.14,,ASIAN HANDICAP,PRE MATCH,PUSH,,
"Germany 0.0 @ 2.000

$100.00 Single",2021-06-29 09:58:53,100.0,100.0,0.0,EURO,2.0,2343.14,,ASIAN HANDICAP,PRE MATCH,PUSH,,
"(0-0) Germany 0.0 @ 2.060

$55.99 Single",2021-06-29 12:26:14,55.99,0.0,-55.99,EURO,2.06,2287.15,,ASIAN HANDICAP,LIVE,LOST,,
"(1-1) Sweden -0.5 @ 3.100

$20.00 Single",2021-06-29 15:21:47,20.0,0.0,-20.0,EURO,3.1,2267.15,,ASIAN HANDICAP,LIVE,LOST,,
"Italy 0.0,-0.5 @ 2.010

$125.00 Single",2021-07-01 12:55:00,125.0,251.25,126.25,EURO,2.01,2393.4,"Italy vs Belgium (2:1)
https://www.notion.so/Euro2020-Knockout-stage-de33691b1052438e8bdf46c40dd25690#af5feb00c74d4ae5a758c1d6b13bea36",ASIAN HANDICAP,PRE MATCH,WIN,,
"Italy -1.0 @ 1.800

$100.00 Single",2021-07-01 12:55:26,100.0,0.0,-100.0,EURO,1.8,2293.4,"Italy vs Belgium (2:1)
https://www.notion.so/Euro2020-Knockout-stage-de33691b1052438e8bdf46c40dd25690#af5feb00c74d4ae5a758c1d6b13bea36",ASIAN HANDICAP,PRE MATCH,LOST,,
"Italy @ 1.66

$100.00 Single",2021-07-01 20:43:11,100.0,166.67,66.67,EURO,1.66,2360.07,"Italy vs Belgium (2:1)
Italy to qualify
",FINAL RESULT,PRE MATCH,WIN,,
"(0-1) Over 2.5 @ 1.920

$20.00 Single",2021-07-02 11:42:40,20.0,0.0,-20.0,EURO,1.92,2340.07,,TOTAL GOAL,LIVE,LOST,,
"(0-0) Italy 0.0,-0.5 @ 1.950

$80.00 Single",2021-07-02 13:54:48,80.0,156.0,76.0,EURO,1.95,2416.07,,ASIAN HANDICAP,LIVE,WIN,,
"Czech Republic 0.0,+0.5 @ 2.090

$43.92 Single",2021-07-02 23:17:15,43.92,0.0,-43.92,EURO,2.09,2372.15,,ASIAN HANDICAP,PRE MATCH,LOST,,
"Czech Republic 2-0 @ 21.00

($20.00 Bet Credits)",2021-07-03 10:15:29,20.0,0.0,-20.0,EURO,21.0,2352.15,,FINAL SCORE,PRE MATCH,LOST,,
"Czech Republic @ 4.20

$30.00 Single",2021-07-03 10:16:06,30.0,0.0,-30.0,EURO,4.2,2322.15,,FINAL RESULT,PRE MATCH,LOST,,
"England -1.0 @ 1.990

$100.00 Single",2021-07-03 13:32:56,100.0,199.0,99.0,EURO,1.99,2421.15,"England vs Ukraine(4:0)
这一场是目前为止史上最大的一注, 比赛分析:
https://www.notion.so/Euro2020-Knockout-stage-de33691b1052438e8bdf46c40dd25690#f9307d84d09f4147b0d555cac6ee1d72",ASIAN HANDICAP,PRE MATCH,WIN,,
"England -1.0 @ 1.990

$200.00 Single",2021-07-03 13:33:25,200.0,398.0,198.0,EURO,1.99,2619.15,"England vs Ukraine(4:0)
这一场是目前为止史上最大的一注, 比赛分析:
https://www.notion.so/Euro2020-Knockout-stage-de33691b1052438e8bdf46c40dd25690#f9307d84d09f4147b0d555cac6ee1d72",ASIAN HANDICAP,PRE MATCH,WIN,,
"England -1.0 @ 1.990

$500.00 Single",2021-07-03 13:34:01,500.0,995.0,495.0,EURO,1.99,3114.15,"England vs Ukraine(4:0)
这一场是目前为止史上最大的一注, 比赛分析:
https://www.notion.so/Euro2020-Knockout-stage-de33691b1052438e8bdf46c40dd25690#f9307d84d09f4147b0d555cac6ee1d72",ASIAN HANDICAP,PRE MATCH,WIN,,
"Italy 2-0 @ 12.00


Free In-Play Bet $20.00",2021-07-05 22:00:45,20.0,0.0,-20.0,EURO,12.0,3094.15,,FINAL SCORE,PRE MATCH,LOST,,
"Italy 0.0,-0.5 @ 2.125

$92.00 Single",2021-07-05 22:01:19,92.0,46.0,-46.0,EURO,2.125,3048.15,,ASIAN HANDICAP,PRE MATCH,LOST,,
"Italy 0.0,-0.5 @ 2.150

$100.00 Single",2021-07-06 12:51:40,100.0,50.0,-50.0,EURO,2.15,2998.15,,ASIAN HANDICAP,PRE MATCH,LOST,,
"Italy @ 2.50

$50.00 Single",2021-07-06 12:55:01,50.0,50.0,0.0,EURO,2.5,2998.15,,FINAL RESULT,PRE MATCH,PUSH,,
"Italy 0.0,-0.5 @ 2.150

$100.00 Single",2021-07-06 12:55:33,100.0,50.0,-50.0,EURO,2.15,2948.15,,ASIAN HANDICAP,PRE MATCH,LOST,,
"Draw @ 3.10

$70.00 Single",2021-07-06 13:38:49,70.0,217.0,147.0,EURO,3.1,3095.15,,FINAL RESULT,PRE MATCH,WIN,,
"Italy 0.0,-0.5 @ 2.140

$100.00 Single",2021-07-06 13:40:15,100.0,50.0,-50.0,EURO,2.14,3045.15,,ASIAN HANDICAP,PRE MATCH,LOST,,
"Draw @ 3.10

$30.00 Single",2021-07-06 13:40:28,30.0,93.0,63.0,EURO,3.1,3108.15,,FINAL RESULT,PRE MATCH,WIN,,
"(0-0) Italy 0.0 @ 1.970

$100.00 Single",2021-07-06 14:17:14,100.0,100.0,0.0,EURO,1.97,3108.15,,ASIAN HANDICAP,LIVE,PUSH,,
"Denmark 2-0 @ 29.00

Free In-Play Bet $20.00",2021-07-07 11:46:17,20.0,0.0,-20.0,EURO,29.0,3088.15,,FINAL SCORE,PRE MATCH,LOST,,
"Over 0.5 @ 1.72

$106.00 Single",2021-07-07 15:56:27,106.0,183.1,77.1,EURO,1.72,3165.25,,TOTAL GOAL,LIVE,WIN,,
"Over 0.5 @ 1.72

$100.00 Single",2021-07-07 15:57:29,100.0,172.73,72.73,EURO,1.72,3237.98,,TOTAL GOAL,LIVE,WIN,,
"MON Canadiens @ 3.30

$5.83 Single",2021-07-07 19:08:18,5.83,0.0,-5.83,NFL,3.3,3232.15,"蒙特里尔加拿大人
NFL决赛，友情支持一手",FINAL RESULT,PRE MATCH,LOST,,
"Italy 2-0 @ 15.00

Free In-Play Bet $20.00",2021-07-09 04:24:32,20.0,0.0,-20.0,EURO,15.0,3212.15,"Italy vs England (1:1)
Euro2020 Final",FINAL SCORE,PRE MATCH,LOST,,
"Draw @ 3.00

$50.00 Single",2021-07-09 04:24:55,50.0,150.0,100.0,EURO,3.0,3312.15,,FINAL RESULT,PRE MATCH,WIN,,
"England 0.0 @ 1.800

$100.00 Single",2021-07-09 08:30:46,100.0,100.0,0.0,EURO,1.8,3312.15,"Italy vs England (1:1)
Euro2020 Final",ASIAN HANDICAP,PRE MATCH,PUSH,,
"Italy 4-1 @ 81.00


$10.00 Single",2021-07-11 09:33:24,10.0,0.0,-10.0,EURO,81.0,3302.15,"Italy vs England (1:1)
Euro2020 Final",FINAL SCORE,PRE MATCH,LOST,,
"England 0.0,-0.5 @ 2.090

$90.00 Single",2021-07-11 12:44:40,90.0,45.0,-45.0,EURO,2.09,3257.15,"Italy vs England (1:1)
Euro2020 Final",ASIAN HANDICAP,PRE MATCH,LOST,,
"(0-1) England 0.0 @ 1.860

$100.00 Single",2021-07-11 14:56:59,100.0,0.0,-100.0,EURO,1.86,3157.15,"Italy vs England (1:1)
Euro2020 Final",ASIAN HANDICAP,LIVE,LOST,,
"(0-1) England 0.0 @ 1.910

$100.00 Single",2021-07-11 15:24:13,100.0,0.0,-100.0,EURO,1.91,3057.15,"Italy vs England (1:1)
Euro2020 Final",ASIAN HANDICAP,LIVE,LOST,,
"(1-1) England 0.0 @ 1.850

$100.00 Single",2021-07-11 15:32:16,100.0,100.0,0.0,EURO,1.85,3057.15,"Italy vs England (1:1)
Euro2020 Final",ASIAN HANDICAP,LIVE,PUSH,,
"England Win in Extra Time @ 3.75

$95.00 Single",2021-07-11 16:01:12,95.0,0.0,-95.0,EURO,3.75,2962.15,"Italy vs England (1:1)
Euro2020 Final",FINAL RESULT,LIVE,LOST,,
"Over 0.5 @ 1.83

$100.00 Single",2021-07-11 16:01:39,100.0,0.0,-100.0,EURO,1.83,2862.15,"Italy vs England (1:1)
Euro2020 Final",TOTAL GOAL,LIVE,LOST,,
"Italy @ 1.90

$100.00 Single",2021-07-11 16:45:18,100.0,190.91,90.91,EURO,1.9,2953.06,"Italy vs England
Penalty shootout
先发点球一方的概率优势, 同时考虑意大利的心理优势",FINAL RESULT,PRE MATCH,WIN,,
"Italy @ 1.90

$300.00 Single",2021-07-11 16:45:29,300.0,572.73,272.73,EURO,1.9,3225.79,"Italy vs England
Penalty shootout
先发点球一方的概率优势, 同时考虑意大利的心理优势",FINAL RESULT,PRE MATCH,WIN,,
"(3-1) Guangzhou FC -0.5 @ 2.150

$50.00 Single",2021-07-18 06:27:09,50.0,0.0,-50.0,,2.15,3175.79,,ASIAN HANDICAP,LIVE,LOST,,
"(0-0) Shanghai Shenhua -1.0 @ 2.600

$50.00 Single",2021-07-19 06:41:00,50.0,50.0,0.0,,2.6,3175.79,,ASIAN HANDICAP,LIVE,PUSH,Shanghai Shenhua,
"Over 2.0 @ 2.050

$50.00 Single",2021-07-22 12:27:21,50.0,102.5,52.5,WWC,2.05,3228.29,"China PR Women v Zambia Women(1st Half Goal Line)
难得买一次大小球, 这个盘口真心白送",TOTAL GOAL,PRE MATCH,WIN,,
"Holland Women 0.0,-0.5 @ 1.900

$100.00 Single",2021-07-23 20:00:00,100.0,50.0,-50.0,WWC,1.9,3178.29,,ASIAN HANDICAP,PRE MATCH,LOST,,
"Holland Women 0.0 @ 1.950

$102.50 Single",2021-07-24 04:59:30,102.5,102.5,0.0,WWC,1.95,3178.29,,ASIAN HANDICAP,PRE MATCH,PUSH,,
"(2-1) Over 5.0 @ 1.850

$52.50 Single",2021-07-27 07:09:20,52.5,97.13,44.63,WWC,1.85,3222.92,"Netherlands Women s China PR Women
(Alternative Goal Line)
这场最后是一个8:2, 超级大球",TOTAL GOAL,LIVE,WIN,,
"(2-1) Over 5.0 @ 2.100

$100.00 Single",2021-07-27 07:15:29,100.0,210.0,110.0,WWC,2.1,3332.92,"Netherlands Women s China PR Women
(Alternative Goal Line)
这场最后是一个8:2, 超级大球",TOTAL GOAL,LIVE,WIN,,
"Canada Women @ 2.87

$107.13 Single",2021-07-27 09:50:42,107.13,96.25,-10.88,,2.87,3322.04,,FINAL RESULT,PRE MATCH,LOST,,
"Canada Women 0.0,+0.5 @ 2.025

$100.00 Single",2021-07-27 16:50:22,100.0,151.25,51.25,WWC,2.025,3373.29,"Canada Women vs Brazil Women(Asian Handicap)
这次女足奥运会拿捏的还是比较准的",ASIAN HANDICAP,PRE MATCH,WIN,,
"Canada Women @ 3.20

$56.25 Single",2021-07-27 19:53:39,56.25,0.0,-56.25,WWC,3.2,3317.04,"Canada Women vs Brazil Women(Asian Handicap)
这次女足奥运会拿捏的还是比较准的",FINAL RESULT,PRE MATCH,LOST,,
"Canada Women 0.0,+0.5 @ 2.075

$40.00 Single",2021-07-27 19:53:54,40.0,61.5,21.5,WWC,2.075,3338.54,"Canada Women vs Brazil Women(Asian Handicap)
这次女足奥运会拿捏的还是比较准的",ASIAN HANDICAP,PRE MATCH,WIN,,
"(0-0) Canada Women 0.0 @ 2.250

$52.75 Single",2021-07-30 05:14:15,52.75,52.75,0.0,WWC,2.25,3338.54,"Canada Women vs Brazil Women(Asian Handicap)
滚球走平手盘目前来看是比较稳的一个选择, 具有很高的安全边际. 优于大小球和某一方进球",ASIAN HANDICAP,LIVE,PUSH,,
"(0-0) Canada Women 0.0 @ 2.250

$60.00 Single",2021-07-30 05:14:28,60.0,60.0,0.0,WWC,2.25,3338.54,"Canada Women vs Brazil Women(Asian Handicap)
滚球走平手盘目前来看是比较稳的一个选择, 具有很高的安全边际. 优于大小球和某一方进球",ASIAN HANDICAP,LIVE,PUSH,,
"Canada Women @ 1.95

$50.00 Single",2021-07-30 05:42:53,50.0,97.5,47.5,,1.95,3386.04,,FINAL RESULT,PRE MATCH,WIN,,
"(0-0) Netherlands Women 0.0 @ 2.150

$60.25 Single",2021-07-30 05:57:57,60.25,60.25,0.0,,2.15,3386.04,,ASIAN HANDICAP,LIVE,PUSH,,
"Miss 2nd Penalty @ 4.00

$10.00 Single",2021-07-31 06:34:36,10.0,0.0,-10.0,,4.0,3376.04,,UNKNOWN,PRE MATCH,LOST,,
"Miss 3rd Penalty @ 3.75

$10.00 Single",2021-07-31 06:34:44,10.0,0.0,-10.0,,3.75,3366.04,,UNKNOWN,PRE MATCH,LOST,,
"Miss 4th Penalty @ 3.50

$10.00 Single",2021-07-31 06:34:55,10.0,0.0,-10.0,,3.5,3356.04,,UNKNOWN,PRE MATCH,LOST,,
"Miss 3rd Penalty @ 3.50

$10.00 Single",2021-07-31 06:35:04,10.0,35.0,25.0,,3.5,3381.04,,UNKNOWN,PRE MATCH,WIN,,
"(1-0) Shanghai Shenhua 0.0 @ 1.900

$55.25 Single",2021-07-31 08:44:47,55.25,55.25,0.0,CSL,1.9,3381.04,,ASIAN HANDICAP,LIVE,PUSH,Shanghai Shenhua,
"(1-0) Shanghai Shenhua 0.0 @ 1.875

$50.00 Single",2021-07-31 08:47:47,50.0,50.0,0.0,CSL,1.875,3381.04,,ASIAN HANDICAP,LIVE,PUSH,Shanghai Shenhua,
"(1-0) Shanghai Shenhua 0.0 @ 1.875

$50.00 Single",2021-07-31 08:58:49,50.0,50.0,0.0,CSL,1.875,3381.04,,ASIAN HANDICAP,LIVE,PUSH,Shanghai Shenhua,
"(0-0) USA 0.0 @ 3.300

$55.25 Single",2021-08-01 21:28:50,55.25,55.25,0.0,,3.3,3381.04,"USA v Mexico(Alternative Asian Handicap)
加勒比金杯赛决赛",ASIAN HANDICAP,LIVE,PUSH,,
"USA @ 7.00

$20.00 Single",2021-08-01 21:29:02,20.0,0.0,-20.0,,7.0,3361.04,"USA v Mexico(Alternative Asian Handicap)
加勒比金杯赛决赛",FINAL RESULT,PRE MATCH,LOST,,
"Japan Olympic @ 5.00

$35.25 Single",2021-08-03 06:14:51,35.25,0.0,-35.25,,5.0,3325.79,,FINAL RESULT,PRE MATCH,LOST,,
"(0-0) Canada Women 0.0 @ 3.100

$50.00 Single",2021-08-06 07:17:58,50.0,50.0,0.0,WWC,3.1,3325.79,"Sweden Women v Canada Women(Asian Handicap - Penalties Converted in Shootout)
女足点球小7的概率非常的大, 点球质量都很低",ASIAN HANDICAP,LIVE,PUSH,,
"(0-0) Canada Women 0.0 @ 2.100

$50.00 Single",2021-08-06 09:33:15,50.0,105.0,55.0,WWC,2.1,3380.79,"Sweden Women v Canada Women(Asian Handicap - Penalties Converted in Shootout)
女足点球小7的概率非常的大, 点球质量都很低",ASIAN HANDICAP,LIVE,WIN,,
"Miss 1st Penalty @ 3.40

$10.00 Single",2021-08-06 09:33:42,10.0,34.0,24.0,,3.4,3404.79,,UNKNOWN,PRE MATCH,WIN,,
"Miss 2nd Penalty @ 3.40

$10.00 Single",2021-08-06 09:33:50,10.0,0.0,-10.0,,3.4,3394.79,,UNKNOWN,PRE MATCH,LOST,,
"Miss 3rd Penalty @ 3.25

$10.00 Single",2021-08-06 09:33:58,10.0,0.0,-10.0,,3.25,3384.79,,UNKNOWN,PRE MATCH,LOST,,
"(1-1) Spain Olympic 0.0 @ 2.000

$59.00 Single",2021-08-07 08:02:25,59.0,59.0,0.0,,2.0,3384.79,,ASIAN HANDICAP,LIVE,PUSH,,
"Over 0.5 @ 2.20

$59.00 Single",2021-08-07 08:32:14,59.0,129.8,70.8,,2.2,3455.59,"Brazil Olympic vs Spain Olympic(Extra Time Goals)
在观察局势后加时追0.5大也是滚球的一个稳健pattern",TOTAL GOAL,LIVE,WIN,,
"Leeds +0.5,+1.0 @ 2.125

$29.80 Single",2021-08-14 06:07:30,29.8,0.0,-29.8,PL,2.125,3425.79,"Leeds vs Man United (1:5)
新赛季欧战第一注，献给利兹联
值得注意的是这个赛季主场有球迷入场后有一定的主场优势",ASIAN HANDICAP,PRE MATCH,LOST,Leeds United,Manchester United
"Chelsea -0.5 @ 1.950

$50.00 Single",2021-08-14 08:10:49,50.0,97.5,47.5,PL,1.95,3473.29,"Chelsea vs Crystal Palace 
切尔西轻松取胜, 从阵容看切尔西是本赛季最大热门",ASIAN HANDICAP,PRE MATCH,WIN,Chelsea,
"(0-0) Osasuna 0.0 @ 1.700

$47.50 Single",2021-08-14 16:39:42,47.5,47.5,0.0,La liga,1.7,3473.29,"　Osasuna v Espanyol (0:0)
武球王回归西甲， 这个赛季应该会看下
滚球平手盘，依然保持不败",ASIAN HANDICAP,LIVE,PUSH,Espanyol,
"Over 2.5 @ 2.070

$50.00 Single",2021-08-15 06:49:29,50.0,50.0,0.0,PL,2.07,3473.29,"Tottenham vs Man City (1:0)
曼城上的轮换阵容, 几个坑逼全数出场
托特那姆没有凯恩其实也不是什么坏事",TOTAL GOAL,PRE MATCH,CASH_OUT,Manchester City,Tottenham
"Tottenham +1.0 @ 1.860

$30.00 Single",2021-08-15 10:29:51,30.0,55.8,25.8,PL,1.86,3499.09,"Tottenham vs Man City (1:0)
曼城上的轮换阵容, 几个坑逼全数出场
托特那姆没有凯恩其实也不是什么坏事",ASIAN HANDICAP,PRE MATCH,WIN,Manchester City,Tottenham
"Barcelona -0.5,-1.0 @ 1.870

$50.00 Single",2021-08-15 12:03:50,50.0,93.5,43.5,La liga,1.87,3542.59,"Barcelona 3: 0  皇家社会
失去梅西其实并不是坏事， 防守和整体性至少会有改善",ASIAN HANDICAP,PRE MATCH,WIN,Barcelona,
"Bayern Munich 0.0,-0.5 @ 2.025

$39.30 Single",2021-08-17 08:13:58,39.3,79.59,40.29,Bundesliga,2.025,3582.88,"Borussia Dortmund v Bayern Munich(Alternative Asian Handicap)
德国超级杯决赛",ASIAN HANDICAP,PRE MATCH,WIN,Bayern Munich,Dortmund
"(0-2) Bayern Munich -0.5 @ 2.375

$30.00 Single",2021-08-17 14:42:25,30.0,0.0,-30.0,Bundesliga,2.375,3552.88,"Borussia Dortmund v Bayern Munich(Alternative Asian Handicap)
这一手贪了一点，滚球走平手盘可保不败",ASIAN HANDICAP,LIVE,LOST,Bayern Munich,Dortmund
"(1-2) Over 4.0 @ 2.250

$29.59 Single",2021-08-21 10:24:18,29.59,29.59,0.0,PL,2.25,3552.88,Leeds v Everton(Alternative Goal Line),TOTAL GOAL,LIVE,PUSH,Leeds United,Everton
"Villarreal 0.0 @ 1.820

$36.97 Single",2021-08-21 12:15:03,36.97,36.97,0.0,La liga,1.82,3552.88,Espanyol v Villarreal(Asian Handicap),ASIAN HANDICAP,PRE MATCH,PUSH,Villarreal,Espanyol
"Chelsea -0.5,-1.0 @ 2.080

$36.97 Single",2021-08-21 21:13:53,36.97,76.9,39.93,,2.08,3592.81,Arsenal v Chelsea(Asian Handicap),ASIAN HANDICAP,PRE MATCH,WIN,Chelsea,Arsenal
"Juventus -1.0 @ 1.980

$40.00 Single",2021-08-22 10:41:18,40.0,0.0,-40.0,Serie A,1.98,3552.81,Udinese v Juventus(Asian Handicap),ASIAN HANDICAP,PRE MATCH,LOST,Juventus,
"Pacos Ferreira +2.0,+2.5 @ 1.900

$26.90 Single",2021-08-26 13:24:25,26.9,0.0,-26.9,,1.9,3525.91,,ASIAN HANDICAP,PRE MATCH,LOST,,
"Pacos Ferreira @ 19.00

$10.00 Single",2021-08-26 13:24:49,10.0,0.0,-10.0,,19.0,3515.91,,FINAL RESULT,PRE MATCH,LOST,,
"Arsenal +1.0,+1.5 @ 2.125

$40.00 Single",2021-08-28 06:18:24,40.0,0.0,-40.0,,2.125,3475.91,,ASIAN HANDICAP,PRE MATCH,LOST,Arsenal,
"(1-1) Liverpool -1.0 @ 2.850

$50.00 Single",2021-08-28 12:53:24,50.0,0.0,-50.0,PL,2.85,3425.91,Liverpool v Chelsea(Alternative Asian Handicap),ASIAN HANDICAP,LIVE,LOST,Liverpool,Chelsea
"Juventus -1.5,-2.0 @ 1.820

$50.00 Single",2021-08-28 13:42:15,50.0,0.0,-50.0,Serie A,1.82,3375.91,Juventus v Empoli(Asian Handicap),ASIAN HANDICAP,PRE MATCH,LOST,Juventus,
